fips,tract,sqmi,district,location,total_pop,hisp,nh,nh_onerace,nh_white,nh_black,nh_american,nh_asian,nh_native,nh_other,nh_twoplus
17031020500,20500,0.297630425,outside,chicago,6599,1432,5167,4965,1357,1524,26,2003,1,54,202
17031020301,20301,0.322267852,outside,chicago,5261,324,4937,4827,3827,153,2,759,0,86,110
17031020302,20302,0.246829444,outside,chicago,5010,1021,3989,3834,2488,615,9,675,1,46,155
17031020400,20400,0.215267165,outside,chicago,4435,1037,3398,3222,1593,957,15,641,0,16,176
17031020601,20601,0.224201432,outside,chicago,6699,1117,5582,5361,3019,459,5,1787,0,91,221
17031020602,20602,0.189842313,outside,chicago,4662,1281,3381,3235,1274,478,10,1396,2,75,146
17031020701,20701,0.228490151,outside,chicago,1879,302,1577,1515,968,72,2,467,0,6,62
17031801601,801601,2.497018272,north,ccdph,4734,165,4569,4473,3651,40,3,776,2,1,96
17031801603,801603,3.156530722,north,ccdph,4138,360,3778,3668,1914,196,16,1527,0,15,110
17031801605,801605,1.852984652,north,ccdph,5883,205,5678,5511,4486,31,2,976,0,16,167
17031110502,110502,0.247142137,outside,chicago,3220,818,2402,2284,1768,63,6,423,2,22,118
17031120100,120100,1.067945909,outside,chicago,4402,475,3927,3735,3457,33,1,227,0,17,192
17031120200,120200,0.931194069,outside,chicago,4748,526,4222,4042,3436,37,4,540,0,25,180
17031120300,120300,0.7929925,outside,chicago,6920,701,6219,5938,4630,85,2,1188,1,32,281
17031120400,120400,0.406610866,outside,chicago,3526,945,2581,2462,1865,53,4,521,0,19,119
17031130100,130100,0.710262642,outside,chicago,5205,362,4843,4738,3075,99,2,1514,0,48,105
17031130200,130200,0.802066483,outside,chicago,1403,328,1075,1017,745,16,0,250,0,6,58
17031130300,130300,0.277906933,outside,chicago,5083,1088,3995,3791,1899,311,17,1542,0,22,204
17031140100,140100,0.111318748,outside,chicago,3464,1818,1646,1572,975,169,11,399,0,18,74
17031140200,140200,0.152906638,outside,chicago,5834,2613,3221,3074,1603,423,18,985,11,34,147
17031140301,140301,0.063286345,outside,chicago,2693,1387,1306,1212,315,129,23,727,0,18,94
17031140302,140302,0.160624702,outside,chicago,4060,1687,2373,2251,1179,241,16,777,2,36,122
17031260800,260800,0.126878833,outside,chicago,2271,99,2172,2121,41,2064,2,3,0,11,51
17031260900,260900,0.088049994,outside,chicago,1778,75,1703,1679,50,1603,8,2,3,13,24
17031261000,261000,0.193413926,outside,chicago,2289,137,2152,2113,18,2082,5,5,0,3,39
17031270500,270500,0.216691324,outside,chicago,1619,49,1570,1534,12,1520,2,0,0,0,36
17031271200,271200,0.127122287,outside,chicago,1172,96,1076,1054,30,1016,0,2,0,6,22
17031271300,271300,0.126470246,outside,chicago,1060,58,1002,984,24,951,2,4,2,1,18
17031271400,271400,0.126601519,outside,chicago,1535,127,1408,1369,66,1292,2,8,1,0,39
17031271500,271500,0.062859872,outside,chicago,1373,79,1294,1269,28,1235,3,3,0,0,25
17031271800,271800,0.079519919,outside,chicago,976,63,913,888,15,862,0,7,1,3,25
17031280100,280100,0.236213585,outside,chicago,7421,447,6974,6696,5245,363,9,1050,4,25,278
17031280400,280400,0.193590142,outside,chicago,1231,72,1159,1125,92,991,2,38,0,2,34
17031280800,280800,0.091669194,outside,chicago,1198,66,1132,1111,43,1056,1,8,0,3,21
17031280900,280900,0.044280916,outside,chicago,1077,66,1011,986,132,826,0,24,0,4,25
17031281900,281900,0.169115454,outside,chicago,7031,398,6633,6355,3264,321,13,2699,4,54,278
17031282700,282700,0.16935178,outside,chicago,2558,615,1943,1857,590,929,1,330,0,7,86
17031282800,282800,0.063507007,outside,chicago,1634,423,1211,1149,551,248,1,332,0,17,62
17031283100,283100,0.083628703,outside,chicago,2717,184,2533,2435,806,748,2,861,0,18,98
17031283200,283200,0.091186978,outside,chicago,1670,160,1510,1443,539,565,1,323,0,15,67
17031283800,283800,0.145376566,outside,chicago,3343,392,2951,2856,994,1497,6,347,1,11,95
17031290900,290900,0.384245722,outside,chicago,3975,347,3628,3572,35,3520,3,6,0,8,56
17031291200,291200,0.126986539,outside,chicago,2286,113,2173,2149,15,2125,2,3,0,4,24
17031291600,291600,0.084868228,outside,chicago,874,549,325,302,122,146,1,26,1,6,23
17031292200,292200,0.152112991,outside,chicago,2942,287,2655,2614,88,2504,6,5,0,11,41
17031292400,292400,0.127230107,outside,chicago,2041,188,1853,1826,40,1784,0,1,0,1,27
17031292500,292500,0.380633067,outside,chicago,4057,367,3690,3623,51,3552,6,6,0,8,67
17031300500,300500,0.104181489,outside,chicago,3243,2817,426,407,94,301,0,4,0,8,19
17031560900,560900,0.506958651,outside,chicago,5112,2097,3015,2946,2847,28,9,37,5,20,69
17031561000,561000,0.514502786,outside,chicago,5308,2082,3226,3149,3032,62,9,29,2,15,77
17031561100,561100,0.510359216,outside,chicago,5581,2969,2612,2566,2470,43,8,24,2,19,46
17031570100,570100,0.586064095,outside,chicago,1316,1044,272,262,156,15,1,89,0,1,10
17031570200,570200,0.681974752,outside,chicago,2096,1659,437,434,267,16,0,149,1,1,3
17031570300,570300,0.378510908,outside,chicago,6376,5468,908,854,644,33,4,163,2,8,54
17031570400,570400,0.176037898,outside,chicago,1769,1401,368,348,194,41,4,101,0,8,20
17031570500,570500,0.161946193,outside,chicago,2639,2092,547,537,401,19,4,109,0,4,10
17031580100,580100,0.293302235,outside,chicago,3228,2036,1192,1177,209,57,0,907,0,4,15
17031580200,580200,0.281580917,outside,chicago,3466,2699,767,753,211,64,1,468,1,8,14
17031580300,580300,0.182096274,outside,chicago,2577,2043,534,516,97,60,0,356,0,3,18
17031580400,580400,0.508000954,outside,chicago,4546,3490,1056,1035,269,67,0,689,0,10,21
17031580501,580501,0.189287609,outside,chicago,5170,4145,1025,1004,369,102,3,515,0,15,21
17031580502,580502,0.191153618,outside,chicago,5345,4442,903,875,226,46,14,560,1,28,28
17031580600,580600,0.190016286,outside,chicago,5405,4499,906,894,319,63,1,487,0,24,12
17031580700,580700,0.212407993,outside,chicago,5621,4588,1033,1007,323,68,4,597,0,15,26
17031580800,580800,0.070789367,outside,chicago,2058,1904,154,146,82,23,1,34,2,4,8
17031590500,590500,0.230045425,outside,chicago,1854,973,881,839,386,34,2,408,0,9,42
17031590600,590600,0.134345674,outside,chicago,3477,2314,1163,1101,521,48,3,526,0,3,62
17031590700,590700,0.340589819,outside,chicago,3027,1941,1086,1035,331,63,2,630,0,9,51
17031600400,600400,0.126269407,outside,chicago,4297,539,3758,3688,939,43,0,2704,0,2,70
17031600600,600600,0.156621043,outside,chicago,2988,907,2081,2039,668,38,1,1313,2,17,42
17031600700,600700,0.190017068,outside,chicago,2591,647,1944,1891,638,86,5,1157,3,2,53
17031600900,600900,0.142678509,outside,chicago,3682,1027,2655,2578,1120,287,7,1145,0,19,77
17031610300,610300,0.918953114,outside,chicago,5410,4716,694,649,266,215,10,149,1,8,45
17031610400,610400,0.062861039,outside,chicago,2029,1932,97,87,50,14,2,19,2,0,10
17031610800,610800,0.130099067,outside,chicago,1512,340,1172,1143,983,38,0,122,0,0,29
17031611200,611200,0.126159412,outside,chicago,2680,2118,562,520,87,384,0,37,2,10,42
17031611300,611300,0.126209985,outside,chicago,3668,3269,399,375,106,250,3,7,0,9,24
17031611400,611400,0.125976467,outside,chicago,3737,3516,221,211,69,129,0,8,0,5,10
17031611500,611500,0.195779061,outside,chicago,3587,3080,507,491,138,317,3,21,0,12,16
17031611600,611600,0.129027232,outside,chicago,1921,1217,704,661,35,614,2,3,0,7,43
17031611700,611700,0.12664018,outside,chicago,2180,1534,646,634,57,570,0,4,0,3,12
17031611800,611800,0.126531816,outside,chicago,2205,1267,938,919,32,876,0,2,2,7,19
17031611900,611900,0.252086908,outside,chicago,1984,880,1104,1079,15,1056,1,1,0,6,25
17031612000,612000,0.125755402,outside,chicago,1448,378,1070,1043,21,1010,0,8,0,4,27
17031612100,612100,0.125960495,outside,chicago,1168,208,960,934,20,905,1,7,0,1,26
17031801701,801701,0.835923389,north,ccdph,3846,143,3703,3561,2988,2,2,562,0,7,142
17031801606,801606,2.437089668,north,ccdph,6716,241,6475,6334,4905,47,5,1315,0,62,141
17031801607,801607,2.153048584,north,ccdph,5225,228,4997,4845,3220,87,1,1526,0,11,152
17031801608,801608,2.656627885,north,ccdph,7057,160,6897,6721,4923,44,3,1735,0,16,176
17031801702,801702,1.2906063,north,ccdph,4756,163,4593,4447,3833,19,0,585,0,10,146
17031801800,801800,4.266928342,north,ccdph,5972,219,5753,5576,4895,43,3,626,0,9,177
17031801901,801901,1.550239192,north,ccdph,5016,1151,3865,3726,3150,69,3,474,4,26,139
17031801902,801902,1.224371517,north,ccdph,3420,186,3234,3124,2808,22,3,279,0,12,110
17031802002,802002,1.23903558,north,ccdph,5130,340,4790,4631,3826,49,7,710,1,38,159
17031802003,802003,0.662200365,north,ccdph,2679,406,2273,2191,1602,56,1,525,0,7,82
17031802004,802004,0.413121101,north,ccdph,5871,957,4914,4820,2461,185,0,2146,0,28,94
17031802100,802100,0.710627122,north,ccdph,3734,116,3618,3425,3142,29,0,230,0,24,193
17031802200,802200,1.712220166,north,ccdph,4848,210,4638,4475,4051,47,1,356,0,20,163
17031802300,802300,2.020492627,north,ccdph,5968,326,5642,5413,3952,67,1,1375,3,15,229
17031802402,802402,2.118200852,north,ccdph,5543,1654,3889,3768,2806,96,3,843,1,19,121
17031802403,802403,0.219728937,north,ccdph,1531,91,1440,1385,1165,17,0,203,0,0,55
17031802404,802404,0.990259237,north,ccdph,7558,3388,4170,4048,3048,159,2,811,4,24,122
17031802503,802503,0.744124767,north,ccdph,6412,1048,5364,5250,3446,149,6,1610,0,39,114
17031802504,802504,1.315568769,north,ccdph,6442,2957,3485,3369,2695,54,3,591,0,26,116
17031802505,802505,2.733564057,north,ccdph,6723,3150,3573,3476,2097,248,7,1077,1,46,97
17031802506,802506,1.429625146,north,ccdph,2285,1165,1120,1087,792,94,2,197,0,2,33
17031802605,802605,2.024379073,north,ccdph,7125,477,6648,6515,5016,104,2,1373,4,16,133
17031802607,802607,0.747066938,north,ccdph,1536,93,1443,1401,1316,5,0,80,0,0,42
17031802608,802608,1.69025767,north,ccdph,6730,324,6406,6256,5540,72,12,615,0,17,150
17031802609,802609,0.377937929,north,ccdph,6290,2695,3595,3517,2275,109,10,1105,0,18,78
17031802610,802610,0.497937364,north,ccdph,1757,164,1593,1548,1191,26,3,317,5,6,45
17031802701,802701,1.234183822,north,ccdph,6682,1472,5210,5066,3917,93,0,1051,0,5,144
17031802702,802702,2.184048726,north,ccdph,4710,312,4398,4298,3092,57,0,1121,0,28,100
17031802801,802801,1.148130629,north,ccdph,5041,433,4608,4470,4091,49,3,314,1,12,138
17031802802,802802,1.373753574,north,ccdph,6991,649,6342,6143,5400,95,3,615,3,27,199
17031802900,802900,1.753182337,north,ccdph,6055,250,5805,5615,5267,35,3,292,0,18,190
17031803005,803005,1.177720611,north,ccdph,2614,175,2439,2386,2112,33,4,226,0,11,53
17031803007,803007,0.991098173,north,ccdph,5153,304,4849,4726,4131,43,6,529,0,17,123
17031803008,803008,0.971074223,north,ccdph,4767,412,4355,4220,3662,54,0,497,3,4,135
17031803010,803010,1.005930978,north,ccdph,5351,590,4761,4590,3941,83,0,553,1,12,171
17031803012,803012,0.568099059,north,ccdph,2234,366,1868,1840,1438,62,5,329,1,5,28
17031803013,803013,0.770085466,north,ccdph,5490,609,4881,4725,4060,52,0,606,1,6,156
17031803014,803014,0.500524996,north,ccdph,3677,862,2815,2762,2306,46,0,397,0,13,53
17031803015,803015,1.275570858,north,ccdph,4631,503,4128,4035,3476,58,8,475,2,16,93
17031803016,803016,0.396710166,north,ccdph,2490,167,2323,2269,1077,26,2,1161,0,3,54
17031803017,803017,1.149165892,north,ccdph,6283,925,5358,5217,4173,132,11,889,0,12,141
17031803100,803100,0.670479517,north,ccdph,3616,180,3436,3288,3047,29,0,198,0,14,148
17031140602,140602,0.142817929,outside,chicago,5041,3070,1971,1852,1000,342,12,434,3,61,119
17031140400,140400,0.455009135,outside,chicago,6503,2118,4385,4084,2548,84,10,1402,1,39,301
17031140500,140500,0.174698414,outside,chicago,3451,1690,1761,1663,1102,65,4,465,7,20,98
17031140601,140601,0.110542718,outside,chicago,2545,1414,1131,1091,509,122,0,451,0,9,40
17031140701,140701,0.086648533,outside,chicago,2784,1488,1296,1208,641,93,7,438,1,28,88
17031140702,140702,0.166179752,outside,chicago,5535,3409,2126,2011,1336,249,6,402,1,17,115
17031140800,140800,0.280134529,outside,chicago,6486,1994,4492,4250,3400,251,5,555,0,39,242
17031150200,150200,0.512103209,outside,chicago,7434,2560,4874,4619,3749,212,15,599,3,41,255
17031150300,150300,0.512518468,outside,chicago,7120,2095,5025,4810,4319,90,16,350,3,32,215
17031150401,150401,0.285733482,outside,chicago,4681,1454,3227,3114,2695,79,9,308,0,23,113
17031150402,150402,0.25463537,outside,chicago,3831,1497,2334,2238,1951,52,2,216,1,16,96
17031150501,150501,0.271498097,outside,chicago,3823,1114,2709,2596,2173,58,3,354,0,8,113
17031150502,150502,0.262496917,outside,chicago,4239,1687,2552,2469,2028,79,15,333,0,14,83
17031150600,150600,0.253147405,outside,chicago,3882,1710,2172,2077,1799,90,16,160,2,10,95
17031150700,150700,0.255569709,outside,chicago,4429,2062,2367,2231,1903,123,1,187,1,16,136
17031150800,150800,0.255185412,outside,chicago,4903,2599,2304,2174,1782,109,8,238,0,37,130
17031151001,151001,0.127330105,outside,chicago,2833,1944,889,833,691,57,4,79,0,2,56
17031151002,151002,0.245811393,outside,chicago,4588,3012,1576,1494,1162,157,15,143,3,14,82
17031151100,151100,0.255009739,outside,chicago,5140,2846,2294,2211,1808,138,11,242,0,12,83
17031151200,151200,0.252924908,outside,chicago,3880,1926,1954,1873,1580,68,3,197,0,25,81
17031160100,160100,0.228690337,outside,chicago,2444,650,1794,1688,1371,41,8,254,7,7,106
17031160200,160200,0.36893563,outside,chicago,3278,761,2517,2361,1946,118,6,271,0,20,156
17031160300,160300,0.164412216,outside,chicago,3769,972,2797,2671,1847,305,8,493,0,18,126
17031160400,160400,0.253599458,outside,chicago,4854,1872,2982,2781,2146,255,18,335,2,25,201
17031160501,160501,0.133690785,outside,chicago,3703,2083,1620,1497,1070,129,0,284,1,13,123
17031160502,160502,0.119456911,outside,chicago,3300,1649,1651,1543,1050,148,7,315,1,22,108
17031160601,160601,0.126441427,outside,chicago,3380,1437,1943,1814,1463,125,8,187,0,31,129
17031160602,160602,0.22610151,outside,chicago,3481,1531,1950,1838,1435,97,1,284,1,20,112
17031160700,160700,0.307383539,outside,chicago,5766,2573,3193,3006,2255,179,10,538,3,21,187
17031160800,160800,0.253412391,outside,chicago,4997,2659,2338,2226,1649,153,9,388,1,26,112
17031160900,160900,0.254093807,outside,chicago,2410,658,1752,1653,1371,84,15,170,0,13,99
17031161000,161000,0.164548698,outside,chicago,1899,451,1448,1405,1225,48,5,114,0,13,43
17031161100,161100,0.222437761,outside,chicago,1940,340,1600,1508,1280,56,3,156,0,13,92
17031808002,808002,1.063236161,north,ccdph,5281,410,4871,4761,2965,125,5,1644,1,21,110
17031808100,808100,1.891203531,north,ccdph,4010,364,3646,3581,3133,60,2,377,0,9,65
17031808200,808200,1.018985695,north,ccdph,5646,544,5102,4986,3463,116,1,1385,0,21,116
17031808301,808301,1.476472259,north,ccdph,6520,514,6006,5816,3333,148,7,2297,0,31,190
17031808302,808302,0.539322738,north,ccdph,4367,372,3995,3825,2081,164,5,1556,0,19,170
17031808400,808400,1.216605796,north,ccdph,4622,381,4241,4096,2414,73,7,1586,0,16,145
17031808500,808500,0.934372187,north,ccdph,4239,383,3856,3715,2405,74,7,1218,0,11,141
17031808600,808600,1.471250531,north,ccdph,2465,164,2301,2211,1958,24,1,221,0,7,90
17031808702,808702,0.338983644,outside,scc,5481,560,4921,4596,2945,319,6,1286,9,31,325
17031808800,808800,0.73135149,outside,scc,3988,199,3789,3600,3085,147,0,350,2,16,189
17031808900,808900,0.55770011,outside,scc,4149,211,3938,3730,3394,125,1,196,0,14,208
17031809000,809000,0.560152785,outside,scc,4001,111,3890,3706,3464,120,0,103,0,19,184
17031809100,809100,0.482862139,outside,scc,3437,155,3282,3075,2806,122,0,140,0,7,207
17031300900,300900,0.126246579,outside,chicago,4553,4286,267,234,139,56,15,18,0,6,33
17031300600,300600,0.1265827,outside,chicago,3253,2672,581,555,96,425,3,14,0,17,26
17031300700,300700,0.127469254,outside,chicago,4798,4500,298,276,95,141,19,15,0,6,22
17031300800,300800,0.125732438,outside,chicago,4136,3937,199,157,53,91,0,5,3,5,42
17031301100,301100,0.080440769,outside,chicago,2323,2007,316,304,166,115,1,11,0,11,12
17031301200,301200,0.187522635,outside,chicago,4087,3317,770,723,237,448,6,22,4,6,47
17031301600,301600,0.127141789,outside,chicago,4995,4874,121,106,65,23,2,2,0,14,15
17031301701,301701,0.127669925,outside,chicago,4279,4149,130,117,52,37,11,10,0,7,13
17031301702,301702,0.127708288,outside,chicago,4121,4032,89,78,49,8,2,3,2,14,11
17031301801,301801,0.267166195,outside,chicago,3947,3816,131,119,72,26,8,7,0,6,12
17031301802,301802,0.134110686,outside,chicago,3376,3243,133,120,56,49,3,3,0,9,13
17031301803,301803,0.135396742,outside,chicago,5107,4962,145,134,108,15,0,2,1,8,11
17031310200,310200,0.123189768,outside,chicago,1588,685,903,839,562,152,3,116,0,6,64
17031310300,310300,0.122864437,outside,chicago,1767,1094,673,608,414,96,0,85,0,13,65
17031310400,310400,0.047989779,outside,chicago,1375,859,516,483,383,44,2,44,1,9,33
17031310500,310500,0.062552275,outside,chicago,1399,1012,387,362,258,54,2,42,2,4,25
17031310600,310600,0.20962511,outside,chicago,5498,3624,1874,1761,1172,359,8,211,0,11,113
17031310700,310700,0.061786725,outside,chicago,1700,1190,510,466,322,99,4,36,1,4,44
17031310800,310800,0.128228304,outside,chicago,4175,3128,1047,968,706,106,0,138,0,18,79
17031310900,310900,0.187120241,outside,chicago,4781,3735,1046,979,699,156,7,76,5,36,67
17031822802,822802,0.504032533,southwest,ccdph,3669,675,2994,2894,2710,121,4,48,0,11,100
17031822900,822900,0.310522004,southwest,ccdph,2078,450,1628,1569,1455,76,0,26,0,12,59
17031823001,823001,1.410728416,southwest,ccdph,6624,1024,5600,5425,4261,915,4,212,0,33,175
17031823002,823002,0.772106638,southwest,ccdph,6006,1012,4994,4816,4392,328,1,79,0,16,178
17031823101,823101,0.630767798,southwest,ccdph,4515,698,3817,3692,3417,165,0,93,0,17,125
17031823102,823102,1.418859035,southwest,ccdph,3642,597,3045,2920,2671,155,2,71,3,18,125
17031823200,823200,2.953294983,southwest,ccdph,4775,1055,3720,3620,3096,368,7,134,6,9,100
17031823302,823302,2.164110928,southwest,ccdph,5739,1347,4392,4264,2091,2041,0,116,0,16,128
17031823303,823303,0.774597573,southwest,ccdph,4581,1436,3145,3040,2338,660,1,29,3,9,105
17031823304,823304,1.372208679,southwest,ccdph,5872,1527,4345,4174,2671,1373,6,102,1,21,171
17031823400,823400,1.987265482,southwest,ccdph,4892,2617,2275,2177,1002,1132,0,37,0,6,98
17031823500,823500,0.429902081,southwest,ccdph,4301,2178,2123,2030,1155,831,11,13,6,14,93
17031823602,823602,1.898879934,southwest,ccdph,6209,631,5578,5455,4998,337,1,106,0,13,123
17031823603,823603,0.967760035,southwest,ccdph,2021,1183,838,813,81,725,0,0,0,7,25
17031823604,823604,1.381242509,southwest,ccdph,3509,228,3281,3190,3057,71,0,57,0,5,91
17031823605,823605,1.340590604,southwest,ccdph,4177,392,3785,3672,3318,284,3,53,0,14,113
17031823702,823702,1.50438569,southwest,ccdph,7050,748,6302,6142,5146,810,3,160,0,23,160
17031823703,823703,2.006691005,southwest,ccdph,8659,1546,7113,6886,6169,255,7,420,0,35,227
17031823704,823704,0.752012608,southwest,ccdph,4191,703,3488,3428,3208,88,1,113,0,18,60
17031823705,823705,0.754057545,southwest,ccdph,4666,762,3904,3756,3430,162,0,145,0,19,148
17031823801,823801,18.85057636,southwest,ccdph,5873,414,5459,5305,5023,44,2,214,2,20,154
17031823803,823803,2.079939314,southwest,ccdph,7146,794,6352,6229,5901,144,6,147,0,31,123
17031823805,823805,0.553591891,southwest,ccdph,3189,229,2960,2884,2716,76,2,64,0,26,76
17031823806,823806,1.127072297,southwest,ccdph,3847,515,3332,3211,2906,175,3,95,1,31,121
17031823901,823901,4.100505307,southwest,ccdph,3515,226,3289,3210,2953,91,0,153,0,13,79
17031823903,823903,2.191323503,southwest,ccdph,4657,305,4352,4272,4119,67,0,70,0,16,80
17031620300,620300,0.382717601,outside,chicago,6410,5241,1169,1153,978,47,9,105,0,14,16
17031612200,612200,0.346453783,outside,chicago,3939,2854,1085,1053,126,894,0,24,0,9,32
17031620100,620100,0.3260773,outside,chicago,4567,3763,804,787,321,163,1,284,2,16,17
17031620200,620200,0.223997534,outside,chicago,2390,1889,501,483,384,40,12,35,0,12,18
17031620400,620400,0.253238481,outside,chicago,5027,4652,375,358,256,29,4,63,0,6,17
17031630300,630300,0.380321314,outside,chicago,5385,5096,289,268,189,27,2,31,1,18,21
17031630400,630400,0.253904821,outside,chicago,7204,6762,442,428,297,37,10,49,1,34,14
17031630500,630500,0.253668958,outside,chicago,6271,5959,312,296,181,58,4,23,0,30,16
17031630600,630600,0.425067437,outside,chicago,3250,2821,429,411,149,167,4,82,4,5,18
17031834400,834400,0.226146541,outside,chicago,3765,111,3654,3539,163,3320,6,29,0,21,115
17031834500,834500,0.178787398,outside,chicago,1765,34,1731,1688,17,1664,0,5,0,2,43
17031834600,834600,0.603063081,outside,chicago,2357,204,2153,2104,21,2056,7,3,0,17,49
17031834700,834700,0.255218081,outside,chicago,1759,153,1606,1569,11,1544,1,4,3,6,37
17031834800,834800,0.233215949,outside,chicago,1753,127,1626,1570,9,1554,0,5,0,2,56
17031834900,834900,0.252013784,outside,chicago,1952,146,1806,1774,6,1756,4,2,0,6,32
17031835000,835000,0.38752585,outside,chicago,6398,3614,2784,2738,89,2619,0,7,0,23,46
17031835100,835100,0.388660679,outside,chicago,5585,4604,981,959,130,759,32,4,0,34,22
17031835200,835200,0.381733254,outside,chicago,2038,1365,673,664,556,59,1,44,2,2,9
17031835500,835500,0.352714353,outside,chicago,1584,212,1372,1322,50,1254,0,9,0,9,50
17031835600,835600,0.354769158,outside,chicago,898,183,715,696,15,672,0,4,0,5,19
17031835800,835800,0.109730329,outside,chicago,1698,48,1650,1586,43,1528,5,8,0,2,64
17031836000,836000,0.19513919,outside,chicago,2338,97,2241,2168,62,2095,3,1,1,6,73
17031836100,836100,0.332839681,outside,chicago,1893,68,1825,1806,20,1772,3,4,0,7,19
17031836200,836200,0.313427648,outside,chicago,2178,242,1936,1802,1086,116,1,575,5,19,134
17031836300,836300,0.05375222,outside,chicago,1492,109,1383,1313,477,701,0,133,0,2,70
17031836400,836400,0.305331362,outside,chicago,3621,144,3477,3374,151,3168,1,33,0,21,103
17031836500,836500,0.177428243,outside,chicago,1527,35,1492,1456,15,1433,0,2,0,6,36
17031836600,836600,0.244935934,outside,chicago,2929,1544,1385,1304,552,696,6,38,0,12,81
17031836700,836700,0.473754444,outside,chicago,2481,587,1894,1837,194,1629,4,5,0,5,57
17031836800,836800,0.314712265,outside,chicago,2645,290,2355,2304,215,2057,2,18,0,12,51
17031836900,836900,0.063541186,outside,chicago,1439,141,1298,1266,53,1202,1,9,0,1,32
17031837000,837000,0.159314475,outside,chicago,2042,163,1879,1840,129,1697,1,7,0,6,39
17031837100,837100,0.289082242,outside,chicago,1652,204,1448,1384,202,1149,2,21,2,8,64
17031837300,837300,0.142227566,outside,chicago,2489,171,2318,2282,111,2154,1,2,0,14,36
17031837400,837400,0.228219903,outside,chicago,1990,223,1767,1717,150,1546,3,15,1,2,50
17031837800,837800,0.386108708,outside,chicago,2837,276,2561,2463,444,1884,7,109,0,19,98
17031838000,838000,0.207695821,outside,chicago,2651,253,2398,2309,470,1677,13,128,0,21,89
17031838100,838100,0.315793151,outside,chicago,1821,141,1680,1610,536,970,4,95,3,2,70
17031838200,838200,0.445488661,outside,chicago,1675,272,1403,1357,475,240,4,616,0,22,46
17031838300,838300,0.134263545,outside,chicago,2580,195,2385,2315,1309,776,5,216,0,9,70
17031838600,838600,0.094881084,outside,chicago,1518,114,1404,1387,67,1295,0,20,0,5,17
17031838700,838700,0.253891023,outside,chicago,4132,290,3842,3765,25,3730,2,0,0,8,77
17031838800,838800,8.354627227,outside,chicago,3102,1316,1786,1743,102,1606,11,3,0,21,43
17031839000,839000,0.199606815,outside,chicago,10435,918,9517,9069,5938,1141,14,1912,7,57,448
17031839100,839100,0.455644915,outside,chicago,8234,765,7469,7105,4358,975,15,1720,1,36,364
17031839200,839200,0.250983273,outside,chicago,2749,104,2645,2553,288,1771,0,465,4,25,92
17031839500,839500,0.10575841,outside,chicago,1590,79,1511,1453,220,1163,3,56,2,9,58
17031809402,809402,0.140886028,outside,scc,3374,221,3153,3026,1949,110,0,933,0,34,127
17031809200,809200,0.46237001,outside,scc,4980,1277,3703,3449,708,2580,7,120,0,34,254
17031809300,809300,0.392303528,outside,scc,5043,390,4653,4387,2801,492,1,1072,1,20,266
17031809401,809401,0.256159768,outside,scc,2747,147,2600,2517,1854,185,6,466,0,6,83
17031809500,809500,0.268825049,outside,scc,4346,275,4071,3867,2692,359,5,775,0,36,204
17031809600,809600,0.501930715,outside,scc,3319,617,2702,2473,1268,1057,8,123,0,17,229
17031809700,809700,0.509343878,outside,scc,3714,815,2899,2691,1547,979,12,124,1,28,208
17031809800,809800,0.231682008,outside,scc,2678,199,2479,2328,1849,289,5,163,6,16,151
17031809900,809900,0.275597075,outside,scc,3046,234,2812,2651,2257,163,4,203,1,23,161
17031810000,810000,0.406995922,outside,scc,5640,426,5214,4907,3977,361,11,521,0,37,307
17031810100,810100,0.279363836,outside,scc,4480,538,3942,3669,2664,666,4,315,0,20,273
17031810200,810200,0.340563337,outside,scc,6222,1066,5156,4811,2025,2277,21,406,5,77,345
17031810301,810301,0.663931984,outside,scc,4105,911,3194,2990,1465,1238,4,258,0,25,204
17031810302,810302,0.301522021,outside,scc,3360,426,2934,2694,1784,740,4,147,0,19,240
17031810400,810400,0.890145341,north,ccdph,5409,440,4969,4812,4547,23,4,225,1,12,157
17031810501,810501,0.879322694,west,ccdph,5293,634,4659,4579,4314,19,0,230,2,14,80
17031810502,810502,0.686891684,west,ccdph,5355,759,4596,4519,4077,23,5,402,0,12,77
17031810600,810600,0.595587989,west,ccdph,4949,1006,3943,3842,3317,50,8,460,0,7,101
17031810701,810701,0.2430294,west,ccdph,4865,2053,2812,2749,2535,65,11,129,0,9,63
17031810702,810702,0.264527063,west,ccdph,3914,1412,2502,2426,2142,181,1,92,0,10,76
17031810800,810800,0.382407812,west,ccdph,5124,1781,3343,3273,3056,72,4,139,0,2,70
17031810900,810900,0.411335609,west,ccdph,6360,2456,3904,3819,3259,274,5,249,7,25,85
17031811000,811000,0.605499769,west,ccdph,4258,897,3361,3280,3083,66,3,123,0,5,81
17031811100,811100,1.412330639,west,ccdph,6703,1873,4830,4711,4434,120,2,134,1,20,119
17031811200,811200,1.317110023,west,ccdph,5401,2160,3241,3140,2860,105,4,153,0,18,101
17031811301,811301,1.136281243,west,ccdph,4802,3181,1621,1552,1226,173,0,135,0,18,69
17031811302,811302,1.543344434,west,ccdph,3565,2576,989,954,622,280,8,36,1,7,35
17031811401,811401,0.563202222,west,ccdph,5001,2640,2361,2293,1996,91,4,186,0,16,68
17031811402,811402,0.624349254,west,ccdph,4572,2375,2197,2118,1785,79,6,217,2,29,79
17031811500,811500,1.086418634,west,ccdph,6031,2817,3214,3141,2864,32,5,221,0,19,73
17031811600,811600,1.131020616,west,ccdph,6053,1839,4214,4118,3637,93,8,368,0,12,96
17031811701,811701,2.794782072,west,ccdph,3455,2484,971,932,771,45,5,102,1,8,39
17031824005,824005,4.354085093,southwest,ccdph,5933,450,5483,5325,5077,55,3,190,0,0,158
17031823904,823904,1.440198575,southwest,ccdph,4043,165,3878,3821,3704,20,2,79,0,16,57
17031824003,824003,1.466832266,southwest,ccdph,6242,430,5812,5677,5542,39,0,73,5,18,135
17031824004,824004,9.241323445,southwest,ccdph,5374,305,5069,4943,4774,42,0,117,1,9,126
17031824006,824006,5.950823658,southwest,ccdph,5096,358,4738,4635,4417,55,0,160,0,3,103
17031824105,824105,1.699795019,southwest,ccdph,7297,568,6729,6559,5960,229,0,350,1,19,170
17031824106,824106,3.311935103,southwest,ccdph,7021,654,6367,6221,5704,200,5,304,0,8,146
17031824107,824107,1.466776765,southwest,ccdph,6747,562,6185,6023,5497,215,4,276,0,31,162
17031824113,824113,2.983129085,southwest,ccdph,6322,412,5910,5746,5277,101,2,348,0,18,164
17031824114,824114,2.414324573,southwest,ccdph,5299,382,4917,4783,4179,216,2,375,1,10,134
17031824115,824115,1.053074598,southwest,ccdph,3843,471,3372,3256,3012,96,3,132,0,13,116
17031824116,824116,3.595273238,southwest,ccdph,5244,710,4534,4396,3839,291,11,221,1,33,138
17031824119,824119,2.976217871,southwest,ccdph,5456,351,5105,4977,4491,156,2,325,0,3,128
17031824121,824121,0.67146798,southwest,ccdph,3138,252,2886,2800,2621,87,0,83,2,7,86
17031824122,824122,1.538418679,south,ccdph,6209,438,5771,5639,5162,163,0,307,0,7,132
17031824123,824123,1.521360075,south,ccdph,7753,810,6943,6732,6058,407,5,251,0,11,211
17031824124,824124,0.772154226,southwest,ccdph,3679,364,3315,3214,2300,607,7,292,0,8,101
17031824125,824125,0.728705833,southwest,ccdph,4098,551,3547,3456,3240,45,1,162,0,8,91
17031824126,824126,1.260570489,south,ccdph,5951,420,5531,5379,4858,174,0,336,0,11,152
17031839900,839900,0.449555838,outside,chicago,4431,1050,3381,3234,2127,133,5,950,0,19,147
17031839600,839600,0.126204143,outside,chicago,1729,74,1655,1604,87,1491,3,17,0,6,51
17031839700,839700,0.250421671,outside,chicago,4545,1449,3096,2984,1730,152,6,1064,0,32,112
17031839800,839800,0.101826708,outside,chicago,2686,538,2148,2066,1029,31,5,994,2,5,82
17031840000,840000,0.220707111,outside,chicago,3001,548,2453,2391,1060,43,0,1273,0,15,62
17031840100,840100,0.128334529,outside,chicago,3029,306,2723,2673,641,31,5,1989,0,7,50
17031840200,840200,0.334745977,outside,chicago,2497,397,2100,2084,401,56,0,1621,0,6,16
17031840300,840300,0.3212665,outside,chicago,4196,2284,1912,1876,446,74,4,1343,0,9,36
17031803200,803200,1.067780061,north,ccdph,5586,278,5308,5172,4849,33,5,268,4,13,136
17031803300,803300,0.765070639,north,ccdph,5726,442,5284,5100,4352,199,9,524,1,15,184
17031803400,803400,1.193408728,north,ccdph,6592,410,6182,5933,5485,72,0,360,0,16,249
17031803500,803500,1.139221198,north,ccdph,5803,310,5493,5326,5025,39,3,232,0,27,167
17031803603,803603,3.902522027,north,ccdph,6824,247,6577,6360,4716,67,5,1551,3,18,217
17031803604,803604,0.97273216,north,ccdph,4209,509,3700,3569,3152,90,4,309,6,8,131
17031020702,20702,0.271247299,outside,chicago,7717,1333,6384,6104,2830,648,17,2504,1,104,280
17031020801,20801,0.253023967,outside,chicago,5648,1506,4142,3958,2159,373,17,1386,0,23,184
17031020802,20802,0.248526372,outside,chicago,7546,1680,5866,5657,1428,888,23,3260,0,58,209
17031020901,20901,0.186378358,outside,chicago,5848,1344,4504,4308,1000,1414,18,1829,0,47,196
17031020902,20902,0.195978907,outside,chicago,4488,800,3688,3562,1434,769,10,1332,0,17,126
17031030101,30101,0.047980581,outside,chicago,3687,504,3183,3047,1772,667,3,573,2,30,136
17031030102,30102,0.044157367,outside,chicago,3121,425,2696,2561,1565,518,7,458,0,13,135
17031030103,30103,0.030580521,outside,chicago,2104,256,1848,1772,1101,260,2,384,0,25,76
17031030104,30104,0.03607189,outside,chicago,3521,384,3137,3037,1918,378,6,667,3,65,100
17031030200,30200,0.257250023,outside,chicago,5627,809,4818,4554,3811,336,4,385,0,18,264
17031030300,30300,0.120658438,outside,chicago,3148,998,2150,2045,1170,470,14,373,0,18,105
17031030400,30400,0.134679244,outside,chicago,2597,657,1940,1825,1366,219,4,223,0,13,115
17031030500,30500,0.238138967,outside,chicago,6183,1192,4991,4661,3726,456,8,440,1,30,330
17031030601,30601,0.057573358,outside,chicago,3293,458,2835,2721,1491,562,5,640,3,20,114
17031030603,30603,0.044780085,outside,chicago,2045,306,1739,1660,897,417,3,329,1,13,79
17031030604,30604,0.053485846,outside,chicago,3737,419,3318,3198,1851,498,3,820,0,26,120
17031030701,30701,0.026948267,outside,chicago,1671,240,1431,1374,791,439,4,126,0,14,57
17031030702,30702,0.007535332,outside,chicago,2318,208,2110,2015,1237,202,5,555,0,16,95
17031030703,30703,0.076518828,outside,chicago,3075,379,2696,2591,1634,576,0,366,1,14,105
17031030706,30706,0.135995735,outside,chicago,2933,276,2657,2538,1604,542,0,373,0,19,119
17031030800,30800,0.218904758,outside,chicago,4284,432,3852,3629,3082,186,1,345,0,15,223
17031030900,30900,0.157377144,outside,chicago,2952,523,2429,2326,1946,94,4,259,5,18,103
17031031000,31000,0.164121848,outside,chicago,3868,682,3186,2992,2537,142,2,291,0,20,194
17031031100,31100,0.212224417,outside,chicago,4691,645,4046,3778,2880,272,9,592,3,22,268
17031031200,31200,0.125974759,outside,chicago,5541,779,4762,4582,1943,1578,10,1022,3,26,180
17031031300,31300,0.216761296,outside,chicago,6719,720,5999,5799,3452,1216,16,1090,0,25,200
17031031400,31400,0.58513225,outside,chicago,5221,510,4711,4530,3505,439,1,550,1,34,181
17031031501,31501,0.061549389,outside,chicago,4155,429,3726,3570,1410,1394,10,717,1,38,156
17031031502,31502,0.062331791,outside,chicago,4712,608,4104,3919,1636,1912,2,345,0,24,185
17031031700,31700,0.184058326,outside,chicago,6294,936,5358,5061,3576,1061,19,381,3,21,297
17031161200,161200,0.199844478,outside,chicago,2820,1688,1132,1065,732,70,6,244,0,13,67
17031161300,161300,0.191971989,outside,chicago,3899,2144,1755,1653,1325,137,8,170,0,13,102
17031170100,170100,0.391518648,outside,chicago,2034,289,1745,1705,1490,118,0,95,0,2,40
17031170200,170200,0.252122917,outside,chicago,3812,1657,2155,2053,1777,40,4,207,2,23,102
17031170300,170300,0.539681678,outside,chicago,5216,1890,3326,3245,2869,73,2,292,0,9,81
17031170400,170400,0.297032921,outside,chicago,4141,1364,2777,2699,2345,73,0,257,0,24,78
17031170500,170500,0.593383852,outside,chicago,5316,1476,3840,3724,3483,79,9,139,1,13,116
17031170600,170600,0.219500329,outside,chicago,2551,603,1948,1904,1720,24,3,154,0,3,44
17031170700,170700,0.222911334,outside,chicago,3068,1019,2049,2006,1859,27,0,108,0,12,43
17031170800,170800,0.282055181,outside,chicago,3799,1329,2470,2387,2147,54,0,180,0,6,83
17031170900,170900,0.123739677,outside,chicago,1662,604,1058,1037,916,54,0,64,0,3,21
17031171000,171000,0.537959689,outside,chicago,7313,2755,4558,4375,3771,171,9,397,0,27,183
17031171100,171100,0.256481209,outside,chicago,4235,2054,2181,2117,1733,103,4,248,0,29,64
17031180100,180100,0.411552167,outside,chicago,6656,3582,3074,2971,2354,267,5,309,2,34,103
17031190100,190100,0.12220869,outside,chicago,2325,1903,422,398,273,37,0,80,1,7,24
17031190200,190200,0.254724872,outside,chicago,5652,4587,1065,1005,705,149,5,125,0,21,60
17031320101,320101,0.177546003,outside,chicago,9532,658,8874,8474,5989,480,12,1934,0,59,400
17031320102,320102,0.185073502,outside,chicago,4846,431,4415,4178,2688,178,6,1268,0,38,237
17031320400,320400,0.305613842,outside,chicago,2856,232,2624,2528,1803,250,4,449,10,12,96
17031320600,320600,0.229516155,outside,chicago,6395,498,5897,5613,3316,784,5,1466,3,39,284
17031330101,330101,0.885657826,outside,chicago,4592,265,4327,4139,2367,477,1,1269,1,24,188
17031330102,330102,0.155172064,outside,chicago,10811,838,9973,9409,5360,1813,8,2162,0,66,564
17031330103,330103,0.197046633,outside,chicago,8248,678,7570,7243,3336,2594,13,1232,3,65,327
17031330200,330200,0.306749307,outside,chicago,4008,226,3782,3576,1440,1158,12,945,1,20,206
17031340300,340300,0.081853578,outside,chicago,1865,103,1762,1745,258,35,3,1440,1,8,17
17031340400,340400,0.112004005,outside,chicago,1844,106,1738,1716,258,48,2,1404,1,3,22
17031340500,340500,0.168870977,outside,chicago,1629,166,1463,1436,662,72,0,700,0,2,27
17031340600,340600,0.189995162,outside,chicago,1151,16,1135,1111,16,1074,1,16,0,4,24
17031350100,350100,0.223412556,outside,chicago,2228,68,2160,2115,176,1029,3,875,2,30,45
17031350400,350400,0.077686609,outside,chicago,1512,84,1428,1398,20,1371,5,1,0,1,30
17031351000,351000,0.328182378,outside,chicago,3640,117,3523,3391,269,2569,12,521,1,19,132
17031351100,351100,0.134114337,outside,chicago,2038,36,2002,1963,33,1902,0,21,0,7,39
17031351400,351400,0.124916735,outside,chicago,1392,71,1321,1277,42,1219,0,9,0,7,44
17031351500,351500,0.064891216,outside,chicago,823,48,775,763,40,626,1,95,0,1,12
17031360200,360200,0.089239089,outside,chicago,1651,25,1626,1592,13,1548,0,24,0,7,34
17031380100,380100,0.169309181,outside,chicago,2207,75,2132,2044,89,1924,1,15,0,15,88
17031380200,380200,0.083026514,outside,chicago,2408,45,2363,2308,50,2239,6,6,0,7,55
17031380600,380600,0.323958622,outside,chicago,3947,103,3844,3763,90,3648,2,12,0,11,81
17031381200,381200,0.099746238,outside,chicago,2077,43,2034,1981,35,1932,6,2,0,6,53
17031381400,381400,0.122129555,outside,chicago,1796,46,1750,1677,38,1623,0,11,0,5,73
17031381500,381500,0.041921552,outside,chicago,667,24,643,628,16,607,3,0,0,2,15
17031381700,381700,0.075024412,outside,chicago,18,9,9,8,1,7,0,0,0,0,1
17031381800,381800,0.122914458,outside,chicago,1462,45,1417,1374,34,1326,0,9,0,5,43
17031381900,381900,0.066990042,outside,chicago,1106,30,1076,1033,28,996,0,3,0,6,43
17031390100,390100,0.184123332,outside,chicago,1553,75,1478,1420,87,1278,1,48,0,6,58
17031630800,630800,0.253018309,outside,chicago,6641,6045,596,568,246,249,0,22,1,50,28
17031630900,630900,0.254562539,outside,chicago,5204,4845,359,344,201,101,0,20,0,22,15
17031640100,640100,0.11679114,outside,chicago,1312,970,342,327,254,57,0,11,0,5,15
17031640300,640300,0.511218023,outside,chicago,6710,4075,2635,2563,2354,116,10,67,0,16,72
17031640400,640400,0.514844896,outside,chicago,3390,1586,1804,1758,1663,51,5,28,0,11,46
17031640500,640500,0.25597548,outside,chicago,3896,1857,2039,1977,1771,126,0,53,0,27,62
17031640600,640600,0.254584648,outside,chicago,4063,2237,1826,1756,1536,124,8,75,0,13,70
17031640700,640700,0.25346436,outside,chicago,3298,2210,1088,1064,973,68,0,19,0,4,24
17031640800,640800,0.12606584,outside,chicago,1799,1533,266,251,210,15,2,24,0,0,15
17031650100,650100,0.25992478,outside,chicago,4765,4281,484,463,316,119,2,16,0,10,21
17031650200,650200,0.382110723,outside,chicago,7251,6262,989,965,873,50,4,36,0,2,24
17031650301,650301,0.380367535,outside,chicago,5829,5049,780,767,670,50,0,35,0,12,13
17031650302,650302,0.256152411,outside,chicago,4522,4120,402,364,261,75,4,16,0,8,38
17031650400,650400,0.424719236,outside,chicago,6894,6275,619,594,331,209,2,41,1,10,25
17031650500,650500,1.249939386,outside,chicago,4401,3391,1010,992,402,556,2,28,0,4,18
17031660301,660301,0.063207494,outside,chicago,1850,1321,529,514,40,443,5,0,0,26,15
17031660302,660302,0.189799654,outside,chicago,5549,4513,1036,995,139,833,3,3,2,15,41
17031660400,660400,0.248715422,outside,chicago,5692,5202,490,455,265,165,0,16,0,9,35
17031660500,660500,0.253842712,outside,chicago,5013,4286,727,698,275,394,0,20,0,9,29
17031660600,660600,0.253896497,outside,chicago,6404,3389,3015,2910,128,2741,5,26,0,10,105
17031660700,660700,0.18609888,outside,chicago,2076,528,1548,1514,16,1490,4,1,0,3,34
17031660800,660800,0.252808366,outside,chicago,6114,3082,3032,2952,128,2780,10,17,4,13,80
17031660900,660900,0.760858995,outside,chicago,4446,1430,3016,2944,142,2765,0,15,0,22,72
17031661000,661000,0.431277045,outside,chicago,5756,1572,4184,4079,90,3951,6,10,0,22,105
17031661100,661100,0.498960768,outside,chicago,6633,4012,2621,2572,259,2262,5,30,0,16,49
17031670100,670100,0.12611785,outside,chicago,1349,318,1031,1020,23,989,4,2,0,2,11
17031670200,670200,0.125990182,outside,chicago,1325,331,994,983,21,954,3,0,0,5,11
17031670300,670300,0.125900837,outside,chicago,1287,335,952,938,8,923,0,7,0,0,14
17031670400,670400,0.125962272,outside,chicago,1585,414,1171,1133,19,1104,0,8,0,2,38
17031670500,670500,0.238724062,outside,chicago,1148,419,729,707,0,706,0,0,0,1,22
17031670600,670600,0.126216479,outside,chicago,1339,353,986,964,5,957,0,0,0,2,22
17031670700,670700,0.126043033,outside,chicago,1252,278,974,952,0,936,1,0,1,14,22
17031670800,670800,0.125936639,outside,chicago,1477,211,1266,1236,18,1205,0,0,0,13,30
17031670900,670900,0.125906028,outside,chicago,1172,235,937,927,3,918,0,3,0,3,10
17031671100,671100,0.094561772,outside,chicago,994,112,882,860,1,848,0,4,0,7,22
17031671200,671200,0.094466147,outside,chicago,980,176,804,780,6,770,2,0,2,0,24
17031671300,671300,0.187001412,outside,chicago,2048,308,1740,1689,6,1674,0,0,0,9,51
17031671400,671400,0.190828781,outside,chicago,1558,417,1141,1112,6,1092,0,1,2,11,29
17031671500,671500,0.285980809,outside,chicago,2716,679,2037,1987,16,1964,3,2,0,2,50
17031671600,671600,0.157040479,outside,chicago,1804,174,1630,1590,2,1575,2,7,3,1,40
17031671800,671800,0.124991735,outside,chicago,1142,136,1006,984,9,967,2,1,0,5,22
17031803612,803612,0.260633736,north,ccdph,3831,1935,1896,1806,1165,331,9,296,0,5,90
17031803607,803607,0.999510253,north,ccdph,4819,464,4355,4184,3816,57,1,293,4,13,171
17031803608,803608,6.199887357,north,ccdph,7544,1159,6385,6100,4869,433,15,744,3,36,285
17031803611,803611,0.442098883,north,ccdph,5698,2577,3121,3028,2127,299,5,578,0,19,93
17031803613,803613,0.301255362,north,ccdph,3434,2402,1032,979,658,66,4,241,0,10,53
17031803614,803614,0.279745707,north,ccdph,4422,2476,1946,1894,1228,226,5,405,1,29,52
17031803615,803615,0.525365457,north,ccdph,2752,379,2373,2304,1627,133,0,539,0,5,69
17031803616,803616,1.188277626,north,ccdph,4635,672,3963,3826,3046,201,11,555,0,13,137
17031803701,803701,0.57318401,north,ccdph,2707,294,2413,2320,2005,35,1,269,0,10,93
17031803702,803702,1.322830937,north,ccdph,6376,549,5827,5628,4639,85,0,874,0,30,199
17031803800,803800,1.2859744,north,ccdph,4522,531,3991,3851,3493,54,4,291,2,7,140
17031803901,803901,2.216626446,north,ccdph,3935,476,3459,3364,2843,82,0,425,0,14,95
17031803902,803902,0.848531463,north,ccdph,3429,715,2714,2601,2444,15,1,132,1,8,113
17031804000,804000,0.976428607,north,ccdph,4763,1005,3758,3604,3209,45,0,331,0,19,154
17031804102,804102,3.288318082,north,ccdph,7307,270,7037,6834,5349,73,6,1387,0,19,203
17031804104,804104,1.126017422,north,ccdph,4949,254,4695,4545,2799,98,4,1632,0,12,150
17031804105,804105,4.961719659,north,ccdph,4168,211,3957,3818,3083,55,1,669,0,10,139
17031804106,804106,1.538761961,north,ccdph,7264,365,6899,6676,4363,73,0,2231,0,9,223
17031804108,804108,0.470272398,north,ccdph,4798,560,4238,4124,1669,463,2,1946,0,44,114
17031804109,804109,0.913594359,north,ccdph,3078,203,2875,2751,2285,52,0,413,0,1,124
17031804202,804202,5.445283993,north,ccdph,7793,474,7319,7104,5419,48,3,1614,0,20,215
17031804203,804203,6.01817784,north,ccdph,3458,120,3338,3246,1921,32,1,1290,0,2,92
17031804204,804204,24.53678827,north,ccdph,5263,281,4982,4836,3906,53,4,859,0,14,146
17031804305,804305,1.161479567,north,ccdph,6952,2642,4310,4130,3091,344,0,677,0,18,180
17031804306,804306,0.982117357,north,ccdph,5626,2954,2672,2551,2226,136,12,164,1,12,121
17031804308,804308,0.876416107,north,ccdph,5518,948,4570,4424,2994,280,0,1113,0,37,146
17031804309,804309,0.790759676,north,ccdph,3038,1416,1622,1556,1172,112,3,265,0,4,66
17031804312,804312,3.173081682,north,ccdph,2238,109,2129,2065,955,62,1,1038,0,9,64
17031804313,804313,1.504779186,north,ccdph,6354,1837,4517,4329,2591,400,7,1316,0,15,188
17031804314,804314,2.525060527,north,ccdph,1682,265,1417,1378,1046,52,0,275,0,5,39
17031804315,804315,0.408654958,north,ccdph,2446,454,1992,1931,1338,83,1,505,1,3,61
17031804316,804316,1.252959495,north,ccdph,5027,1209,3818,3711,2027,267,6,1402,1,8,107
17031804403,804403,1.678701439,north,ccdph,7297,2568,4729,4516,2801,541,7,1132,3,32,213
17031804404,804404,1.195584295,north,ccdph,5147,3237,1910,1833,1302,170,0,351,2,8,77
17031804405,804405,0.64490308,north,ccdph,3570,2316,1254,1171,634,354,3,168,0,12,83
17031804406,804406,2.734528824,north,ccdph,6292,3405,2887,2763,1705,233,5,807,0,13,124
17031804505,804505,1.191746796,north,ccdph,3970,818,3152,2994,2484,168,5,325,2,10,158
17031804506,804506,1.93916351,north,ccdph,5472,699,4773,4645,3406,206,1,1020,0,12,128
17031803605,803605,1.243473108,north,ccdph,7002,1346,5656,5487,4337,198,13,915,0,24,169
17031040100,40100,0.772000831,outside,chicago,3905,747,3158,2989,2438,233,7,299,0,12,169
17031031800,31800,0.090803489,outside,chicago,1910,375,1535,1458,1225,68,0,155,1,9,77
17031031900,31900,0.099448446,outside,chicago,2522,312,2210,2090,1736,167,3,174,0,10,120
17031032100,32100,0.166171176,outside,chicago,7543,1043,6500,6174,4267,1284,8,574,2,39,326
17031040201,40201,0.278292078,outside,chicago,6408,1250,5158,4891,4070,189,16,597,1,18,267
17031040202,40202,0.227144389,outside,chicago,7318,1633,5685,5471,3066,560,21,1797,0,27,214
17031040300,40300,0.295322281,outside,chicago,2928,450,2478,2350,1587,98,0,638,2,25,128
17031040401,40401,0.144913492,outside,chicago,3129,544,2585,2425,2161,64,0,174,1,25,160
17031040402,40402,0.236265631,outside,chicago,4746,675,4071,3847,3378,144,6,286,0,33,224
17031040600,40600,0.127806334,outside,chicago,2530,335,2195,2093,1917,39,2,125,1,9,102
17031040700,40700,0.137670919,outside,chicago,3426,542,2884,2728,2362,111,2,241,0,12,156
17031040800,40800,0.088573564,outside,chicago,1636,200,1436,1343,1212,41,1,83,1,5,93
17031040900,40900,0.124138207,outside,chicago,2063,293,1770,1681,1490,47,5,132,0,7,89
17031050100,50100,0.129036051,outside,chicago,2568,320,2248,2149,1984,40,0,115,4,6,99
17031050200,50200,0.251683115,outside,chicago,5309,731,4578,4339,3903,68,0,328,1,39,239
17031050300,50300,0.152976878,outside,chicago,2671,482,2189,2069,1826,39,3,192,3,6,120
17031190601,190601,0.264729875,outside,chicago,4382,3713,669,642,417,131,5,74,0,15,27
17031190300,190300,0.254801443,outside,chicago,5738,4046,1692,1644,1337,123,9,135,1,39,48
17031190401,190401,0.25291479,outside,chicago,4325,2980,1345,1296,927,108,2,242,4,13,49
17031190402,190402,0.25234858,outside,chicago,5294,3787,1507,1457,1073,154,3,215,0,12,50
17031190602,190602,0.241230974,outside,chicago,5378,4559,819,782,533,149,2,87,1,10,37
17031190701,190701,0.107137872,outside,chicago,2972,2490,482,447,283,101,1,54,1,7,35
17031190702,190702,0.147975195,outside,chicago,4952,4381,571,550,317,171,2,46,1,13,21
17031190800,190800,0.255121749,outside,chicago,6831,5939,892,845,585,147,4,83,0,26,47
17031190900,190900,0.121417996,outside,chicago,1927,1573,354,336,200,82,0,50,0,4,18
17031191000,191000,0.167647161,outside,chicago,2422,2165,257,237,138,63,8,24,0,4,20
17031191100,191100,0.317381064,outside,chicago,7533,6711,822,765,426,251,17,54,1,16,57
17031191200,191200,0.272653627,outside,chicago,3810,3567,243,219,138,46,5,8,0,22,24
17031191301,191301,0.259232105,outside,chicago,5214,4446,768,735,254,324,1,115,0,41,33
17031191302,191302,0.244706827,outside,chicago,4940,4390,550,516,232,206,3,57,3,15,34
17031200100,200100,0.225480124,outside,chicago,4118,3150,968,907,688,102,1,104,0,12,61
17031200200,200200,0.316113792,outside,chicago,5162,4371,791,743,480,178,11,64,1,9,48
17031200300,200300,0.09714912,outside,chicago,2015,1714,301,276,199,56,1,16,0,4,25
17031200401,200401,0.155474048,outside,chicago,3743,3326,417,388,200,146,2,29,0,11,29
17031200402,200402,0.148348897,outside,chicago,4192,3688,504,468,273,130,10,39,0,16,36
17031210100,210100,0.330491995,outside,chicago,4066,1682,2384,2233,1819,112,5,267,0,30,151
17031210400,210400,0.162519998,outside,chicago,2912,1955,957,905,686,101,8,86,0,24,52
17031210501,210501,0.117345082,outside,chicago,3555,1926,1629,1533,1271,121,12,110,2,17,96
17031210502,210502,0.136924082,outside,chicago,4099,2333,1766,1665,1423,107,7,107,1,20,101
17031210601,210601,0.104181218,outside,chicago,2717,1439,1278,1184,898,82,8,182,1,13,94
17031210602,210602,0.148517776,outside,chicago,4148,2394,1754,1652,1348,154,4,136,0,10,102
17031210700,210700,0.191510922,outside,chicago,3907,1877,2030,1919,1653,92,3,163,0,8,111
17031210800,210800,0.063207393,outside,chicago,986,503,483,452,383,19,1,46,0,3,31
17031210900,210900,0.218811787,outside,chicago,3170,1344,1826,1707,1378,119,10,177,1,22,119
17031220300,220300,0.125815306,outside,chicago,2207,518,1689,1596,1406,55,2,122,0,11,93
17031811702,811702,1.053960333,west,ccdph,5384,3492,1892,1824,1455,163,3,181,3,19,68
17031811800,811800,1.422696547,west,ccdph,5644,3366,2278,2205,1941,93,4,153,0,14,73
17031811900,811900,1.378812974,west,ccdph,6051,584,5467,5219,4040,503,6,609,0,61,248
17031812000,812000,1.100885156,west,ccdph,5666,407,5259,4992,4268,366,3,323,0,32,267
17031812100,812100,0.401803515,outside,scc,4763,389,4374,4045,2538,1298,5,175,3,26,329
17031812200,812200,0.571000484,outside,scc,3984,274,3710,3468,2772,487,3,196,0,10,242
17031812301,812301,0.233984332,outside,scc,4978,475,4503,4287,2968,795,0,499,2,23,216
17031812302,812302,0.26029514,outside,scc,2681,220,2461,2276,1796,332,0,133,0,15,185
17031812400,812400,0.536466369,outside,scc,3458,185,3273,3072,2669,185,0,197,0,21,201
17031812500,812500,0.37215554,outside,scc,3680,345,3335,3172,1896,1128,2,137,0,9,163
17031812600,812600,0.24253469,outside,scc,3898,440,3458,3220,1857,1150,4,173,2,34,238
17031812700,812700,0.2466236,outside,scc,3192,295,2897,2709,1894,579,0,218,0,18,188
17031812801,812801,0.122647688,outside,scc,3387,360,3027,2859,1850,741,2,246,0,20,168
17031812802,812802,0.143251048,outside,scc,2521,232,2289,2155,1503,499,1,133,0,19,134
17031812900,812900,0.431612474,outside,scc,4846,427,4419,4141,3428,455,0,238,0,20,278
17031813000,813000,0.321306416,outside,scc,3935,379,3556,3296,2399,727,4,142,2,22,260
17031813100,813100,0.382449118,outside,scc,4678,553,4125,3817,2353,1213,7,224,3,17,308
17031390500,390500,0.125942478,outside,chicago,1666,82,1584,1500,431,953,1,103,0,12,84
17031390200,390200,0.117562447,outside,chicago,1883,68,1815,1734,225,1453,2,47,2,5,81
17031390300,390300,0.126169961,outside,chicago,2617,68,2549,2502,101,2371,10,11,2,7,47
17031390400,390400,0.125948506,outside,chicago,2871,75,2796,2693,260,2373,6,29,0,25,103
17031390600,390600,0.12485279,outside,chicago,1994,89,1905,1794,780,901,2,97,0,14,111
17031390700,390700,0.226295747,outside,chicago,6532,306,6226,5943,1237,3636,5,1029,1,35,283
17031400300,400300,0.564830572,outside,chicago,1504,54,1450,1434,20,1406,5,2,0,1,16
17031400400,400400,0.126105045,outside,chicago,1995,59,1936,1897,11,1880,5,1,0,0,39
17031400500,400500,0.125922638,outside,chicago,2372,78,2294,2259,25,2232,0,2,0,0,35
17031400800,400800,0.190525682,outside,chicago,3178,87,3091,3022,17,2970,9,2,4,20,69
17031410100,410100,0.086157124,outside,chicago,2272,150,2122,2017,640,1139,0,228,3,7,105
17031410200,410200,0.024975629,outside,chicago,1165,148,1017,940,459,334,0,145,0,2,77
17031410500,410500,0.100628767,outside,chicago,2922,247,2675,2548,821,1335,5,375,1,11,127
17031410600,410600,0.09739283,outside,chicago,2371,186,2185,2033,963,573,5,485,0,7,152
17031410700,410700,0.10022626,outside,chicago,2399,180,2219,2074,1079,534,0,434,2,25,145
17031410800,410800,0.095666443,outside,chicago,2993,253,2740,2586,1038,870,5,659,0,14,154
17031410900,410900,0.150494068,outside,chicago,3670,351,3319,3132,1505,1190,1,416,1,19,187
17031824127,824127,1.184830358,south,ccdph,3706,229,3477,3406,3134,128,3,135,0,6,71
17031824128,824128,3.232087244,southwest,ccdph,4638,251,4387,4290,3803,171,8,296,0,12,97
17031824129,824129,2.772844976,southwest,ccdph,4357,260,4097,4012,3622,135,2,248,1,4,85
17031824300,824300,1.550346553,south,ccdph,4499,527,3972,3880,274,3576,2,11,0,17,92
17031824400,824400,1.207076783,southwest,ccdph,2007,421,1586,1533,707,795,2,22,0,7,53
17031824503,824503,4.796115505,southwest,ccdph,6880,792,6088,5893,5322,386,0,163,0,22,195
17031824505,824505,1.045078021,south,ccdph,6783,922,5861,5650,4616,482,23,496,3,30,211
17031824507,824507,1.986010177,south,ccdph,4136,425,3711,3590,3227,240,0,113,0,10,121
17031824508,824508,1.399866831,southwest,ccdph,3699,335,3364,3290,2996,157,9,113,0,15,74
17031824509,824509,1.120978062,southwest,ccdph,4154,579,3575,3471,3134,257,6,67,0,7,104
17031824601,824601,1.315011525,south,ccdph,4392,790,3602,3440,3076,272,0,67,0,25,162
17031824602,824602,1.386407375,south,ccdph,6245,1139,5106,4878,4208,493,14,153,0,10,228
17031824701,824701,0.671732051,south,ccdph,3782,1319,2463,2332,1786,463,5,68,3,7,131
17031824702,824702,0.84900939,south,ccdph,5453,2196,3257,3097,2079,959,3,38,0,18,160
17031824800,824800,1.78645505,south,ccdph,7178,4347,2831,2723,1077,1455,13,160,0,18,108
17031824900,824900,2.139632767,south,ccdph,3244,894,2350,2290,426,1822,2,28,0,12,60
17031825000,825000,2.316576231,south,ccdph,4766,871,3895,3744,2887,463,17,322,0,55,151
17031825200,825200,0.9225768,south,ccdph,2016,681,1335,1278,889,274,5,109,0,1,57
17031825302,825302,2.247254402,south,ccdph,5938,790,5148,4970,4035,682,0,232,0,21,178
17031825303,825303,0.746014306,south,ccdph,3785,459,3326,3258,2933,250,0,67,0,8,68
17031825304,825304,0.900319189,south,ccdph,3923,340,3583,3467,3109,171,0,172,0,15,116
17031825400,825400,2.882912549,south,ccdph,5337,443,4894,4748,4236,371,1,117,4,19,146
17031825501,825501,2.326294608,south,ccdph,5766,348,5418,5291,518,4723,8,19,0,23,127
17031825503,825503,1.972883001,south,ccdph,6540,335,6205,6000,762,5176,6,31,0,25,205
17031825504,825504,1.010155824,south,ccdph,3591,162,3429,3332,153,3118,7,28,0,26,97
17031825505,825505,2.008647103,south,ccdph,5364,248,5116,4993,343,4582,6,52,0,10,123
17031825600,825600,2.410117525,south,ccdph,5138,879,4259,4126,409,3631,7,72,0,7,133
17031825700,825700,1.935163043,south,ccdph,4046,1035,3011,2939,491,2419,2,12,0,15,72
17031825801,825801,1.020296258,south,ccdph,3569,159,3410,3345,128,3196,0,9,0,12,65
17031680600,680600,0.125959568,outside,chicago,1165,167,998,975,6,966,1,2,0,0,23
17031671900,671900,0.124338369,outside,chicago,1122,159,963,928,10,901,0,5,0,12,35
17031672000,672000,0.383693011,outside,chicago,3397,631,2766,2710,18,2673,5,3,0,11,56
17031680500,680500,0.126100104,outside,chicago,1307,150,1157,1124,9,1114,0,0,0,1,33
17031680900,680900,0.396762928,outside,chicago,3573,117,3456,3376,25,3325,13,3,0,10,80
17031840400,840400,0.386486743,outside,chicago,3369,1396,1973,1929,489,36,4,1387,1,12,44
17031840700,840700,0.208804269,outside,chicago,3900,3371,529,501,294,145,10,47,0,5,28
17031840800,840800,0.126862332,outside,chicago,3332,3238,94,75,61,8,2,1,0,3,19
17031841000,841000,0.393505895,outside,chicago,1136,94,1042,988,278,528,2,173,0,7,54
17031841100,841100,0.445946253,outside,chicago,7356,203,7153,7074,338,292,0,6439,0,5,79
17031841200,841200,0.241663085,outside,chicago,4873,3653,1220,1137,779,230,3,106,0,19,83
17031841300,841300,0.543933518,outside,chicago,4173,3167,1006,935,690,142,5,80,1,17,71
17031841500,841500,0.165609935,outside,chicago,2904,165,2739,2690,46,2630,4,1,0,9,49
17031841700,841700,0.102593505,outside,chicago,1509,707,802,771,115,645,5,3,2,1,31
17031841800,841800,0.635031299,outside,chicago,2404,67,2337,2272,8,2253,3,4,0,4,65
17031841900,841900,0.988478799,outside,chicago,6500,968,5532,5382,2454,988,17,1761,0,162,150
17031842000,842000,0.222840673,outside,chicago,2590,200,2390,2329,672,1123,1,479,5,49,61
17031842100,842100,0.784599554,outside,chicago,6650,3702,2948,2868,202,2611,4,26,0,25,80
17031842200,842200,0.593226969,outside,chicago,4212,279,3933,3754,2376,954,4,400,1,19,179
17031842300,842300,0.726033684,outside,chicago,3529,413,3116,2988,2235,448,4,287,0,14,128
17031842400,842400,0.768395267,outside,chicago,3041,53,2988,2943,16,2909,5,7,0,6,45
17031842500,842500,0.412860147,outside,chicago,2644,62,2582,2538,0,2534,3,1,0,0,44
17031842600,842600,1.418479388,outside,chicago,4245,1493,2752,2681,1780,214,5,670,0,12,71
17031842800,842800,0.585508673,outside,chicago,7637,6910,727,708,369,41,3,282,1,12,19
17031842900,842900,0.850792258,outside,chicago,2480,356,2124,2058,356,1629,2,62,0,9,66
17031843000,843000,0.410945278,outside,chicago,2880,140,2740,2700,16,2665,8,4,0,7,40
17031843100,843100,0.391488785,outside,chicago,1747,136,1611,1582,137,1428,2,10,2,3,29
17031843200,843200,1.185447015,outside,chicago,2422,1827,595,561,392,106,11,46,0,6,34
17031843300,843300,0.226240625,outside,chicago,1572,384,1188,1153,96,1031,6,16,0,4,35
17031843400,843400,0.25239587,outside,chicago,1524,553,971,951,29,913,5,0,0,4,20
17031843500,843500,0.785772919,outside,chicago,6030,1782,4248,4230,503,3677,10,33,0,7,18
17031843600,843600,0.158492052,outside,chicago,3089,141,2948,2843,99,2706,4,12,0,22,105
17031843700,843700,0.485933066,outside,chicago,2544,483,2061,1915,1569,91,3,243,0,9,146
17031843800,843800,0.505174311,outside,chicago,2000,695,1305,1263,389,728,2,134,0,10,42
17031843900,843900,0.615051943,outside,chicago,3666,99,3567,3435,228,3145,6,29,3,24,132
17031844600,844600,0.167847566,outside,chicago,1776,48,1728,1697,48,1631,0,6,0,12,31
17031844700,844700,0.155402716,outside,chicago,2342,414,1928,1876,68,1788,2,7,0,11,52
17031980000,980000,7.707872919,outside,chicago,0,0,0,0,0,0,0,0,0,0,0
17031980100,980100,1.151585307,outside,chicago,18,6,12,9,3,3,0,0,1,2,3
17031990000,990000,NA,NA,NA,0,0,0,0,0,0,0,0,0,0,0
17031813400,813400,0.428340311,west,ccdph,7571,6668,903,858,506,279,1,53,0,19,45
17031813200,813200,0.430637121,outside,scc,4582,506,4076,3799,2923,611,1,233,0,31,277
17031813301,813301,0.249973743,west,ccdph,3634,3247,387,358,154,186,2,11,4,1,29
17031813302,813302,0.249875222,west,ccdph,3858,3581,277,268,95,157,0,0,0,16,9
17031813500,813500,0.318148917,west,ccdph,7169,6150,1019,969,504,377,5,66,0,17,50
17031813600,813600,0.2706315,west,ccdph,5443,4980,463,436,268,105,2,31,2,28,27
17031813701,813701,0.257547945,west,ccdph,3886,3388,498,463,148,281,5,24,0,5,35
17031813702,813702,0.14462822,west,ccdph,4199,3842,357,331,147,163,4,14,0,3,26
17031813801,813801,0.323730444,west,ccdph,2856,2667,189,161,95,53,1,8,2,2,28
17031813802,813802,0.225104271,west,ccdph,4958,4452,506,487,289,129,5,50,1,13,19
17031813900,813900,0.266786925,west,ccdph,6768,5827,941,913,514,354,8,27,0,10,28
17031814000,814000,0.240897562,west,ccdph,4706,4132,574,554,330,187,2,28,2,5,20
17031814100,814100,0.499885734,west,ccdph,4683,4159,524,498,255,215,0,13,3,12,26
17031814200,814200,0.947190234,west,ccdph,7671,7152,519,497,358,102,9,20,0,8,22
17031814300,814300,0.350804719,west,ccdph,4690,4218,472,448,301,91,14,32,0,10,24
17031814400,814400,0.641315956,west,ccdph,7781,6830,951,902,762,88,5,37,0,10,49
17031814500,814500,0.447009749,west,ccdph,5395,4597,798,762,606,103,8,42,0,3,36
17031814600,814600,0.318636918,west,ccdph,5616,3807,1809,1737,1038,535,8,125,0,31,72
17031814700,814700,0.333254293,west,ccdph,5548,3585,1963,1869,1226,410,5,215,0,13,94
17031814800,814800,0.551984855,west,ccdph,6445,3890,2555,2457,1495,735,10,196,0,21,98
17031814900,814900,0.238881074,west,ccdph,6557,3913,2644,2535,1181,1179,5,143,2,25,109
17031815000,815000,0.207393328,west,ccdph,4254,3023,1231,1182,609,447,21,93,2,10,49
17031815100,815100,0.25705969,west,ccdph,4318,3135,1183,1115,756,238,3,98,0,20,68
17031815200,815200,0.558938449,west,ccdph,6901,4921,1980,1890,1460,271,1,123,2,33,90
17031815300,815300,0.301660214,west,ccdph,3756,2100,1656,1565,1309,156,14,82,0,4,91
17031815400,815400,0.544815283,west,ccdph,5545,2437,3108,2978,2418,400,8,140,3,9,130
17031815500,815500,0.588425196,west,ccdph,8310,5915,2395,2308,1880,251,4,150,0,23,87
17031815600,815600,1.258085908,west,ccdph,5608,2045,3563,3433,2906,311,10,185,0,21,130
17031815701,815701,0.726785256,west,ccdph,4124,730,3394,3252,3067,79,0,87,0,19,142
17031826000,826000,0.755031894,south,ccdph,2660,1023,1637,1555,223,1313,10,0,3,6,82
17031825802,825802,0.578023152,south,ccdph,5862,632,5230,5122,194,4905,0,10,0,13,108
17031825803,825803,0.671297276,south,ccdph,5908,516,5392,5285,248,4997,4,0,0,36,107
17031825900,825900,0.623163564,south,ccdph,3296,990,2306,2223,269,1928,4,4,0,18,83
17031826100,826100,1.403959514,south,ccdph,5931,1816,4115,4021,734,3259,14,5,0,9,94
17031826201,826201,2.331355077,south,ccdph,3844,226,3618,3544,272,3250,7,7,0,8,74
17031826202,826202,0.837049055,south,ccdph,5710,1198,4512,4405,701,3654,12,22,1,15,107
17031826301,826301,0.953458625,south,ccdph,3923,290,3633,3527,203,3286,3,15,0,20,106
17031826303,826303,0.601647314,south,ccdph,4068,104,3964,3884,142,3689,10,0,0,43,80
17031826304,826304,0.492242961,south,ccdph,2874,105,2769,2730,77,2619,2,5,1,26,39
17031826401,826401,1.251980699,south,ccdph,3725,182,3543,3478,59,3397,2,5,0,15,65
17031826402,826402,0.779822142,south,ccdph,4728,220,4508,4425,122,4285,4,7,0,7,83
17031826500,826500,1.385646583,south,ccdph,5614,278,5336,5222,170,5016,5,8,0,23,114
17031826600,826600,0.583593841,south,ccdph,4595,161,4434,4355,120,4212,0,3,2,18,79
17031826700,826700,0.43060211,south,ccdph,4573,121,4452,4393,137,4214,8,9,3,22,59
17031826800,826800,3.0649674,south,ccdph,4596,1883,2713,2627,548,2024,13,27,2,13,86
17031804508,804508,0.358326711,north,ccdph,2343,1105,1238,1184,533,398,1,243,0,9,54
17031804509,804509,0.83448409,north,ccdph,6012,3515,2497,2372,1405,324,9,612,0,22,125
17031804510,804510,0.542217006,north,ccdph,5872,4543,1329,1263,869,152,4,213,2,23,66
17031804511,804511,0.35046419,north,ccdph,2426,1466,960,913,398,100,0,408,0,7,47
17031804512,804512,1.43254887,north,ccdph,3995,478,3517,3394,1837,350,2,1186,1,18,123
17031804513,804513,1.981279962,north,ccdph,4065,458,3607,3489,2330,124,5,1008,3,19,118
17031804514,804514,2.609302826,north,ccdph,4690,732,3958,3840,2544,78,1,1208,0,9,118
17031804603,804603,4.580053993,north,ccdph,5651,1101,4550,4394,2337,444,2,1582,1,28,156
17031804606,804606,1.964145969,north,ccdph,7088,458,6630,6437,4940,83,2,1395,1,16,193
17031050500,50500,0.25178013,outside,chicago,5117,448,4669,4388,3938,71,2,351,0,26,281
17031050600,50600,0.128137294,outside,chicago,2443,241,2202,2090,1904,41,2,143,0,0,112
17031050700,50700,0.063522417,outside,chicago,1513,135,1378,1309,1218,26,0,60,0,5,69
17031050800,50800,0.062823111,outside,chicago,1406,133,1273,1186,1071,15,2,95,0,3,87
17031050900,50900,0.062782525,outside,chicago,1426,181,1245,1184,1079,20,1,77,0,7,61
17031051000,51000,0.064145718,outside,chicago,1538,218,1320,1262,1107,38,0,109,0,8,58
17031051100,51100,0.062788179,outside,chicago,1599,209,1390,1306,1225,13,3,61,0,4,84
17031051200,51200,0.063440115,outside,chicago,1581,196,1385,1310,1219,25,0,56,0,10,75
17031051300,51300,0.124318181,outside,chicago,2907,309,2598,2473,2218,65,4,180,0,6,125
17031051400,51400,0.138554012,outside,chicago,2492,417,2075,1937,1538,228,4,152,0,15,138
17031060100,60100,0.125871361,outside,chicago,2830,311,2519,2384,2146,88,1,126,1,22,135
17031060200,60200,0.122856651,outside,chicago,2313,351,1962,1846,1630,82,5,128,0,1,116
17031060300,60300,0.123496829,outside,chicago,3076,310,2766,2616,2354,29,1,224,0,8,150
17031060400,60400,0.125394605,outside,chicago,3709,310,3399,3248,2932,48,5,252,1,10,151
17031060500,60500,0.088013281,outside,chicago,1374,193,1181,1139,938,59,2,134,1,5,42
17031060800,60800,0.070399287,outside,chicago,5295,572,4723,4508,3421,336,8,716,1,26,215
17031060900,60900,0.205440988,outside,chicago,7104,815,6289,6010,4805,526,7,637,3,32,279
17031061000,61000,0.066715069,outside,chicago,2279,248,2031,1945,1717,98,9,105,0,16,86
17031061100,61100,0.066774186,outside,chicago,1367,113,1254,1194,1119,25,1,45,1,3,60
17031061200,61200,0.067345883,outside,chicago,1932,162,1770,1682,1531,53,0,94,0,4,88
17031061500,61500,0.062906632,outside,chicago,1797,138,1659,1590,1459,26,2,97,0,6,69
17031061800,61800,0.031823917,outside,chicago,1051,117,934,897,739,55,1,94,0,8,37
17031061901,61901,0.059824321,outside,chicago,3625,363,3262,3118,2553,188,3,349,1,24,144
17031061902,61902,0.188454737,outside,chicago,4665,333,4332,4169,3585,181,5,374,3,21,163
17031062000,62000,0.086941762,outside,chicago,2843,256,2587,2439,2150,79,1,199,4,6,148
17031062100,62100,0.09435133,outside,chicago,3817,344,3473,3317,2892,132,1,284,0,8,156
17031062200,62200,0.094013231,outside,chicago,3244,213,3031,2891,2636,81,0,169,0,5,140
17031062300,62300,0.063023251,outside,chicago,1667,133,1534,1442,1316,18,1,95,0,12,92
17031062400,62400,0.062847019,outside,chicago,1673,137,1536,1447,1338,32,1,72,0,4,89
17031062500,62500,0.062131988,outside,chicago,1675,153,1522,1461,1273,76,5,97,0,10,61
17031062600,62600,0.12732216,outside,chicago,2477,232,2245,2105,1819,20,0,258,0,8,140
17031062700,62700,0.12538982,outside,chicago,2955,252,2703,2587,2322,56,5,182,1,21,116
17031062800,62800,0.125609947,outside,chicago,3851,261,3590,3394,3112,86,1,177,0,18,196
17031062900,62900,0.125664161,outside,chicago,4125,315,3810,3652,3356,68,3,210,0,15,158
17031063000,63000,0.125142182,outside,chicago,3417,300,3117,2957,2554,109,3,287,0,4,160
17031220400,220400,0.12714739,outside,chicago,2579,703,1876,1770,1597,47,4,115,0,7,106
17031220500,220500,0.134159666,outside,chicago,2751,691,2060,1960,1672,133,3,127,0,25,100
17031220601,220601,0.072914735,outside,chicago,1635,564,1071,998,888,44,0,53,0,13,73
17031220602,220602,0.174165775,outside,chicago,4877,1636,3241,3044,2537,292,0,193,1,21,197
17031220701,220701,0.100406236,outside,chicago,2920,1734,1186,1107,914,102,0,75,0,16,79
17031220702,220702,0.224091811,outside,chicago,3653,2009,1644,1540,1245,159,2,111,0,23,104
17031220901,220901,0.113090814,outside,chicago,2903,2001,902,849,557,212,3,62,1,14,53
17031220902,220902,0.127508461,outside,chicago,2959,2096,863,810,713,64,1,27,0,5,53
17031221000,221000,0.08485397,outside,chicago,2432,1283,1149,1066,862,133,6,49,0,16,83
17031221100,221100,0.1698749,outside,chicago,4440,1829,2611,2452,2053,234,10,150,0,5,159
17031221200,221200,0.127436002,outside,chicago,2954,913,2041,1935,1629,182,1,108,0,15,106
17031221300,221300,0.127362262,outside,chicago,3062,924,2138,2030,1739,113,1,168,2,7,108
17031221400,221400,0.137034124,outside,chicago,3385,1248,2137,2025,1735,75,5,192,5,13,112
17031221500,221500,0.117589741,outside,chicago,2909,1054,1855,1758,1393,213,0,145,0,7,97
17031221600,221600,0.125935679,outside,chicago,3159,510,2649,2476,2174,63,3,217,1,18,173
17031222200,222200,0.08913153,outside,chicago,2156,258,1898,1802,1596,57,0,140,0,9,96
17031222500,222500,0.06204319,outside,chicago,1415,523,892,822,710,72,0,36,1,3,70
17031222600,222600,0.061983055,outside,chicago,1599,575,1024,965,808,98,0,51,0,8,59
17031222700,222700,0.086576805,outside,chicago,2082,945,1137,1069,770,212,9,66,0,12,68
17031411000,411000,0.333757342,outside,chicago,3902,275,3627,3435,1621,1211,9,574,0,20,192
17031411100,411100,0.110060373,outside,chicago,2379,222,2157,1998,1335,193,3,440,2,25,159
17031411200,411200,0.155412469,outside,chicago,1713,87,1626,1531,998,173,2,332,0,26,95
17031420100,420100,0.325582584,outside,chicago,1642,42,1600,1555,25,1518,2,5,0,5,45
17031420200,420200,0.111271166,outside,chicago,1781,96,1685,1620,185,1345,4,80,0,6,65
17031420300,420300,0.094849876,outside,chicago,2818,261,2557,2398,871,1082,2,420,0,23,159
17031420400,420400,0.094554045,outside,chicago,1544,83,1461,1401,236,985,4,167,0,9,60
17031420500,420500,0.094910882,outside,chicago,2053,43,2010,1953,50,1883,1,14,0,5,57
17031420600,420600,0.094026613,outside,chicago,2524,65,2459,2388,70,2302,9,2,1,4,71
17031420700,420700,0.251006914,outside,chicago,3021,115,2906,2827,37,2772,4,3,0,11,79
17031420800,420800,0.13404526,outside,chicago,2457,73,2384,2310,54,2242,1,7,0,6,74
17031421200,421200,0.125742963,outside,chicago,1405,37,1368,1340,15,1312,1,2,0,10,28
17031430101,430101,0.126278737,outside,chicago,4091,74,4017,3908,64,3818,4,4,2,16,109
17031430102,430102,0.171482872,outside,chicago,3104,82,3022,2923,77,2808,5,13,3,17,99
17031430200,430200,0.255045836,outside,chicago,5086,149,4937,4782,174,4581,7,13,2,5,155
17031430300,430300,0.157125635,outside,chicago,2558,53,2505,2451,11,2412,4,9,2,13,54
17031430400,430400,0.210048587,outside,chicago,3031,94,2937,2886,49,2827,5,0,1,4,51
17031430500,430500,0.13233737,outside,chicago,4098,101,3997,3908,26,3853,3,3,0,23,89
17031430600,430600,0.128709521,outside,chicago,1670,29,1641,1586,43,1510,1,13,0,19,55
17031430700,430700,0.073629718,outside,chicago,2175,70,2105,2041,70,1959,2,6,0,4,64
17031430800,430800,0.126560483,outside,chicago,1862,43,1819,1790,24,1754,1,6,1,4,29
17031430900,430900,0.129820127,outside,chicago,1797,29,1768,1747,13,1725,2,0,0,7,21
17031431200,431200,0.252846624,outside,chicago,2898,86,2812,2735,30,2687,8,7,0,3,77
17031431301,431301,0.155841065,outside,chicago,3590,63,3527,3434,33,3374,4,9,0,14,93
17031431302,431302,0.168837806,outside,chicago,4351,112,4239,4143,23,4103,4,7,0,6,96
17031431400,431400,0.400685919,outside,chicago,6716,193,6523,6341,176,6107,14,32,0,12,182
17031440101,440101,0.145289122,outside,chicago,4171,64,4107,4048,25,4014,0,1,0,8,59
17031440102,440102,0.24280913,outside,chicago,3633,49,3584,3517,24,3480,1,8,1,3,67
17031440201,440201,0.205145919,outside,chicago,5054,61,4993,4886,29,4831,7,0,1,18,107
17031440202,440202,0.30153433,outside,chicago,3525,42,3483,3414,19,3371,5,6,3,10,69
17031440300,440300,0.500026333,outside,chicago,4677,62,4615,4469,23,4428,5,4,0,9,146
17031440600,440600,0.257544519,outside,chicago,1996,51,1945,1906,6,1889,0,5,0,6,39
17031681000,681000,0.251710456,outside,chicago,2573,119,2454,2412,31,2370,6,2,0,3,42
17031681100,681100,0.251695968,outside,chicago,2873,118,2755,2712,30,2669,1,2,0,10,43
17031681200,681200,0.307181851,outside,chicago,2353,126,2227,2189,15,2158,5,0,1,10,38
17031681300,681300,0.276625556,outside,chicago,2182,85,2097,2049,9,2034,4,0,0,2,48
17031681400,681400,0.249367329,outside,chicago,2474,239,2235,2179,13,2151,3,6,0,6,56
17031690300,690300,0.197465817,outside,chicago,2302,49,2253,2220,33,2172,0,6,0,9,33
17031690400,690400,0.25117694,outside,chicago,3363,62,3301,3212,19,3161,0,7,2,23,89
17031690500,690500,0.124675838,outside,chicago,992,20,972,946,9,934,3,0,0,0,26
17031690900,690900,0.252755741,outside,chicago,4250,116,4134,4038,14,4005,6,2,0,11,96
17031691000,691000,0.250364771,outside,chicago,2668,39,2629,2545,18,2510,1,3,0,13,84
17031691100,691100,0.261128748,outside,chicago,2980,76,2904,2857,19,2822,2,0,0,14,47
17031691200,691200,0.391110616,outside,chicago,2277,29,2248,2208,5,2197,0,0,0,6,40
17031691300,691300,0.249753688,outside,chicago,2374,33,2341,2294,20,2260,5,0,0,9,47
17031691400,691400,0.253299713,outside,chicago,3411,81,3330,3234,13,3211,0,0,0,10,96
17031691500,691500,0.262180554,outside,chicago,1806,34,1772,1736,5,1720,4,2,0,5,36
17031700100,700100,0.894043872,outside,chicago,3326,1475,1851,1799,101,1668,4,4,1,21,52
17031700200,700200,0.626820296,outside,chicago,6554,5116,1438,1389,647,690,0,42,0,10,49
17031700301,700301,0.493031088,outside,chicago,5762,4334,1428,1373,800,495,0,60,0,18,55
17031700302,700302,0.509184455,outside,chicago,5662,3475,2187,2100,1160,901,4,25,0,10,87
17031700401,700401,0.571982932,outside,chicago,5822,2522,3300,3245,308,2900,6,24,0,7,55
17031700402,700402,0.443217709,outside,chicago,4082,1391,2691,2627,271,2309,2,27,0,18,64
17031700501,700501,0.642927605,outside,chicago,6912,639,6273,6157,211,5905,6,15,0,20,116
17031700502,700502,0.66745687,outside,chicago,2978,205,2773,2719,112,2572,0,14,1,20,54
17031710100,710100,0.083071072,outside,chicago,1015,57,958,942,13,924,4,0,1,0,16
17031710200,710200,0.286339829,outside,chicago,4635,176,4459,4389,25,4337,3,11,0,13,70
17031710300,710300,0.126223687,outside,chicago,1424,96,1328,1292,2,1286,0,2,2,0,36
17031710400,710400,0.386765681,outside,chicago,5424,330,5094,5011,23,4970,2,3,0,13,83
17031710500,710500,0.289021041,outside,chicago,4036,146,3890,3818,17,3774,13,3,0,11,72
17031710600,710600,0.094494089,outside,chicago,1706,40,1666,1630,7,1610,9,1,0,3,36
17031710700,710700,0.189090423,outside,chicago,3420,103,3317,3263,11,3231,6,3,0,12,54
17031710800,710800,0.314901319,outside,chicago,4804,80,4724,4616,26,4565,10,3,0,12,108
17031710900,710900,0.382450524,outside,chicago,1942,36,1906,1864,0,1854,0,4,0,6,42
17031711000,711000,0.252583334,outside,chicago,3058,111,2947,2913,19,2871,6,6,0,11,34
17031711100,711100,0.252299592,outside,chicago,2499,77,2422,2353,2,2349,1,0,0,1,69
17031711200,711200,0.423925818,outside,chicago,4687,142,4545,4495,21,4454,3,5,0,12,50
17031711300,711300,0.134911691,outside,chicago,1462,43,1419,1373,10,1354,0,1,1,7,46
17031711400,711400,0.288243713,outside,chicago,2394,109,2285,2263,10,2246,3,0,0,4,22
17031711500,711500,0.250347744,outside,chicago,2372,66,2306,2251,5,2234,3,1,0,8,55
17031720100,720100,0.757329422,outside,chicago,3344,201,3143,3046,1910,1101,2,19,0,14,97
17031720200,720200,0.645682997,outside,chicago,4131,229,3902,3728,1422,2254,7,24,0,21,174
17031720300,720300,0.488135484,outside,chicago,3637,227,3410,3281,2098,1129,1,36,0,17,129
17031720400,720400,0.256049955,outside,chicago,1961,159,1802,1766,1582,168,0,15,0,1,36
17031720500,720500,0.401679721,outside,chicago,2086,125,1961,1918,1830,57,1,19,0,11,43
17031804610,804610,0.643228706,north,ccdph,2524,139,2385,2324,1586,33,0,701,0,4,61
17031804607,804607,1.403969378,north,ccdph,7123,475,6648,6480,4833,147,10,1472,0,18,168
17031804608,804608,1.052803882,north,ccdph,4027,511,3516,3393,2102,110,3,1174,0,4,123
17031804609,804609,1.487148099,north,ccdph,6147,418,5729,5574,2743,141,8,2668,0,14,155
17031804611,804611,0.975566418,north,ccdph,4653,327,4326,4188,3240,101,5,836,0,6,138
17031804701,804701,4.911837205,north,ccdph,7045,1653,5392,5197,2707,764,13,1687,0,26,195
17031804705,804705,0.763042402,north,ccdph,4148,832,3316,3166,1848,308,6,975,0,29,150
17031804706,804706,0.649089448,north,ccdph,2553,309,2244,2151,1712,39,0,396,0,4,93
17031804709,804709,1.191325019,north,ccdph,6814,1259,5555,5392,3381,257,10,1719,2,23,163
17031804710,804710,0.855597674,north,ccdph,4292,535,3757,3614,2905,114,7,576,0,12,143
17031804711,804711,0.833051262,north,ccdph,7629,1591,6038,5764,2939,596,14,2183,2,30,274
17031804712,804712,0.931713214,north,ccdph,5456,606,4850,4682,3098,353,12,1203,0,16,168
17031804713,804713,0.627858018,north,ccdph,5037,542,4495,4343,2002,192,18,2102,0,29,152
17031804714,804714,0.905728615,north,ccdph,3534,522,3012,2882,2258,107,7,502,1,7,130
17031804715,804715,0.325155286,north,ccdph,3426,1387,2039,1985,826,109,14,1018,0,18,54
17031804716,804716,0.892973191,north,ccdph,5360,698,4662,4548,2233,265,6,2029,0,15,114
17031804803,804803,2.194463809,north,ccdph,5721,647,5074,4930,3417,229,5,1266,0,13,144
17031804804,804804,1.889393684,north,ccdph,6809,1521,5288,5097,3411,304,10,1353,0,19,191
17031804805,804805,1.273815327,north,ccdph,6860,1094,5766,5517,4225,183,8,1076,2,23,249
17031804806,804806,0.446574723,north,ccdph,3796,1241,2555,2422,1368,388,18,634,1,13,133
17031804807,804807,0.911876357,north,ccdph,5224,776,4448,4279,3330,202,1,736,0,10,169
17031804808,804808,0.594019691,north,ccdph,2596,227,2369,2264,1937,27,0,297,0,3,105
17031804809,804809,0.884687961,north,ccdph,4259,320,3939,3799,3076,87,6,615,0,15,140
17031804810,804810,1.185825433,north,ccdph,7097,886,6211,5992,4209,294,7,1456,6,20,219
17031804901,804901,1.104900962,north,ccdph,6927,420,6507,6254,5661,70,0,505,0,18,253
17031804902,804902,1.007450191,north,ccdph,5626,588,5038,4883,3735,107,5,1013,0,23,155
17031805001,805001,1.194143822,north,ccdph,4985,268,4717,4611,4278,28,5,287,0,13,106
17031805002,805002,0.728109417,north,ccdph,7422,1609,5813,5633,3716,383,6,1505,0,23,180
17031805105,805105,1.142243139,north,ccdph,7278,3217,4061,3919,2806,213,5,863,11,21,142
17031805106,805106,0.657761845,north,ccdph,2778,171,2607,2557,2269,26,2,259,0,1,50
17031805107,805107,1.259792214,north,ccdph,6793,2211,4582,4400,2813,357,0,1211,1,18,182
17031805108,805108,0.581105675,north,ccdph,6400,1836,4564,4429,2489,400,4,1513,3,20,135
17031805109,805109,0.991300303,north,ccdph,4396,240,4156,4075,3516,51,1,490,0,17,81
17031805110,805110,0.748834744,north,ccdph,4440,251,4189,4102,3643,39,0,404,0,16,87
17031805111,805111,1.493873633,north,ccdph,7786,2505,5281,5109,3182,352,8,1522,6,39,172
17031805112,805112,1.164652447,north,ccdph,3482,727,2755,2688,1746,72,6,851,0,13,67
17031063303,63303,0.092592519,outside,chicago,1274,76,1198,1165,998,20,0,143,0,4,33
17031063200,63200,0.173657487,outside,chicago,6900,599,6301,6045,5118,239,5,664,1,18,256
17031063301,63301,0.035878541,outside,chicago,2833,216,2617,2492,2055,169,4,250,0,14,125
17031063302,63302,0.047089283,outside,chicago,4577,352,4225,4009,3332,162,5,487,1,22,216
17031063400,63400,0.061488518,outside,chicago,2417,206,2211,2098,1814,104,0,168,3,9,113
17031070101,70101,0.271386467,outside,chicago,4171,264,3907,3744,3232,107,2,383,0,20,163
17031070102,70102,0.047003927,outside,chicago,3063,240,2823,2683,2286,109,2,270,1,15,140
17031070103,70103,0.026826117,outside,chicago,1845,113,1732,1673,1397,66,2,192,1,15,59
17031070200,70200,0.132288133,outside,chicago,4200,344,3856,3675,3212,122,2,318,0,21,181
17031070300,70300,0.125199023,outside,chicago,4349,292,4057,3887,3531,75,5,266,2,8,170
17031063100,63100,0.061712262,outside,chicago,2376,173,2203,2085,1830,51,4,189,0,11,118
17031230200,230200,0.082814529,outside,chicago,1834,1123,711,662,451,152,0,54,0,5,49
17031222800,222800,0.04299778,outside,chicago,960,550,410,381,279,81,0,16,0,5,29
17031222900,222900,0.084399116,outside,chicago,1089,723,366,329,243,63,3,15,0,5,37
17031230100,230100,0.064195575,outside,chicago,1504,655,849,799,557,202,0,39,1,0,50
17031230300,230300,0.041250107,outside,chicago,956,716,240,226,124,78,2,19,1,2,14
17031230400,230400,0.129252175,outside,chicago,2235,1798,437,391,258,101,1,27,0,4,46
17031230500,230500,0.203513254,outside,chicago,3419,2946,473,456,105,308,0,23,5,15,17
17031230600,230600,0.389860891,outside,chicago,6817,4795,2022,1968,230,1707,7,15,0,9,54
17031230700,230700,0.249669581,outside,chicago,6218,5038,1180,1106,447,550,4,78,0,27,74
17031230800,230800,0.078859802,outside,chicago,1234,938,296,262,147,85,0,20,0,10,34
17031230900,230900,0.174355162,outside,chicago,5044,2998,2046,1928,1188,641,5,63,0,31,118
17031231100,231100,0.067876734,outside,chicago,1214,552,662,643,55,578,1,2,0,7,19
17031231200,231200,0.253319046,outside,chicago,5983,2947,3036,2963,143,2790,2,7,0,21,73
17031231500,231500,0.385553217,outside,chicago,5655,1398,4257,4171,122,4019,5,13,0,12,86
17031240200,240200,0.064096348,outside,chicago,1556,210,1346,1279,1089,57,0,131,0,2,67
17031240300,240300,0.064372893,outside,chicago,1362,150,1212,1149,1047,15,0,84,0,3,63
17031240500,240500,0.090372067,outside,chicago,2610,241,2369,2267,1999,51,1,211,0,5,102
17031240600,240600,0.063855202,outside,chicago,1489,423,1066,1019,880,47,1,86,0,5,47
17031240700,240700,0.064181066,outside,chicago,1499,636,863,816,545,191,4,68,2,6,47
17031240800,240800,0.063992963,outside,chicago,1687,725,962,882,697,106,4,64,0,11,80
17031240900,240900,0.385936538,outside,chicago,1122,472,650,614,418,132,3,50,0,11,36
17031241000,241000,0.080006471,outside,chicago,2363,980,1383,1314,847,387,5,61,0,14,69
17031241100,241100,0.12766929,outside,chicago,3574,1120,2454,2327,1806,336,0,170,1,14,127
17031241200,241200,0.126611814,outside,chicago,1714,302,1412,1348,1154,66,3,124,0,1,64
17031241300,241300,0.063278698,outside,chicago,1848,252,1596,1499,1213,172,1,111,0,2,97
17031241400,241400,0.200128798,outside,chicago,5273,560,4713,4477,3789,357,8,317,1,5,236
17031241500,241500,0.116611746,outside,chicago,2954,447,2507,2376,2013,85,0,266,0,12,131
17031815702,815702,1.293283894,west,ccdph,5302,890,4412,4248,4028,83,3,112,0,22,164
17031815800,815800,0.769315605,west,ccdph,1630,239,1391,1329,1306,11,1,10,0,1,62
17031815900,815900,0.255567855,west,ccdph,4773,475,4298,4104,2094,1675,10,283,0,42,194
17031816000,816000,0.490298065,west,ccdph,3307,280,3027,2863,1965,670,4,192,3,29,164
17031816100,816100,2.363006732,west,ccdph,6259,868,5391,5155,2697,2000,12,404,0,42,236
17031816200,816200,0.742283437,west,ccdph,4163,1918,2245,2209,1602,458,4,135,1,9,36
17031816300,816300,0.356283914,west,ccdph,4778,3427,1351,1314,1032,181,0,88,0,13,37
17031816401,816401,0.25401198,west,ccdph,4664,4127,537,509,343,140,0,17,0,9,28
17031816402,816402,0.396620603,west,ccdph,4460,3595,865,846,565,258,2,15,0,6,19
17031816500,816500,1.341010074,west,ccdph,4262,3579,683,654,468,142,2,29,1,12,29
17031816600,816600,0.326611299,west,ccdph,4522,4037,485,465,278,134,3,44,0,6,20
17031816700,816700,0.444258231,west,ccdph,2693,1999,694,638,441,127,0,68,0,2,56
17031816800,816800,1.843588414,west,ccdph,5765,2034,3731,3600,1577,1771,13,223,3,13,131
17031816900,816900,0.570309381,west,ccdph,5561,1985,3576,3506,182,3222,10,77,1,14,70
17031817000,817000,0.839898747,west,ccdph,5510,1635,3875,3816,191,3583,7,16,0,19,59
17031817101,817101,0.381865452,west,ccdph,4563,760,3803,3686,107,3539,1,20,0,19,117
17031817102,817102,0.594712867,west,ccdph,3158,657,2501,2447,65,2361,1,6,1,13,54
17031817200,817200,0.4228431,west,ccdph,4821,1325,3496,3413,69,3311,5,11,0,17,83
17031817300,817300,0.282005663,west,ccdph,2799,1155,1644,1599,21,1572,0,6,0,0,45
17031817400,817400,0.422993108,west,ccdph,3652,2389,1263,1210,374,798,0,31,0,7,53
17031450300,450300,0.52628211,outside,chicago,3252,73,3179,3120,11,3093,2,5,0,9,59
17031440700,440700,0.126361831,outside,chicago,1497,21,1476,1445,14,1427,0,3,0,1,31
17031440800,440800,0.108769811,outside,chicago,1620,24,1596,1562,7,1544,0,5,1,5,34
17031440900,440900,0.287148874,outside,chicago,2462,49,2413,2374,5,2352,2,0,0,15,39
17031460100,460100,1.157253207,outside,chicago,2840,537,2303,2198,91,2092,1,3,0,11,105
17031460200,460200,0.231561433,outside,chicago,1948,993,955,935,83,834,14,4,0,0,20
17031460301,460301,0.18730901,outside,chicago,2987,901,2086,2010,76,1917,3,5,1,8,76
17031460302,460302,0.249370707,outside,chicago,3282,350,2932,2839,54,2773,3,1,0,8,93
17031460400,460400,0.251763395,outside,chicago,3411,118,3293,3209,21,3165,0,4,0,19,84
17031460500,460500,0.492913487,outside,chicago,5400,97,5303,5176,41,5108,2,12,0,13,127
17031460800,460800,0.263684827,outside,chicago,3639,1348,2291,2244,73,2147,7,0,0,17,47
17031461000,461000,0.240130329,outside,chicago,1460,410,1050,1013,43,962,2,5,0,1,37
17031470100,470100,0.612118798,outside,chicago,2527,65,2462,2406,4,2386,8,4,0,4,56
17031480100,480100,0.25474824,outside,chicago,2001,14,1987,1948,5,1936,0,3,0,4,39
17031826901,826901,0.504951105,south,ccdph,1462,266,1196,1167,12,1148,0,0,0,7,29
17031826902,826902,0.271615379,south,ccdph,1255,197,1058,1035,18,1004,0,5,0,8,23
17031827000,827000,0.562163418,south,ccdph,2968,406,2562,2499,63,2394,11,9,0,22,63
17031827100,827100,0.621945007,south,ccdph,2265,275,1990,1943,41,1741,0,158,0,3,47
17031827200,827200,1.514262272,south,ccdph,3693,923,2770,2724,135,2541,9,9,3,27,46
17031827300,827300,0.629192045,south,ccdph,2277,484,1793,1750,62,1484,0,187,3,14,43
17031827400,827400,1.100030986,south,ccdph,3230,448,2782,2722,102,2607,1,3,3,6,60
17031827500,827500,2.649360405,south,ccdph,4465,2307,2158,2100,210,1868,7,0,1,14,58
17031827600,827600,0.873361014,south,ccdph,3012,220,2792,2733,19,2696,2,3,0,13,59
17031827700,827700,0.524351064,south,ccdph,2452,282,2170,2120,212,1875,7,14,2,10,50
17031827801,827801,1.09249102,south,ccdph,4645,398,4247,4131,782,3316,1,20,0,12,116
17031827802,827802,0.709504284,south,ccdph,3314,243,3071,2996,220,2737,2,20,1,16,75
17031827804,827804,0.584938993,south,ccdph,3149,172,2977,2901,314,2553,3,18,0,13,76
17031827805,827805,1.111452059,south,ccdph,2953,168,2785,2734,284,2438,5,0,0,7,51
17031827901,827901,1.579421566,south,ccdph,2421,55,2366,2308,163,2117,4,16,0,8,58
17031827902,827902,1.506589013,south,ccdph,4558,878,3680,3545,883,2552,2,69,0,39,135
17031828000,828000,0.982897368,south,ccdph,5411,1352,4059,3920,1610,2256,2,24,1,27,139
17031828100,828100,0.906968122,south,ccdph,5083,1092,3991,3873,2035,1767,13,26,0,32,118
17031828201,828201,1.401676245,south,ccdph,4491,977,3514,3404,1166,2161,7,34,1,35,110
17031828202,828202,0.928236305,south,ccdph,4590,672,3918,3768,1224,2485,3,47,1,8,150
17031828300,828300,4.590533347,south,ccdph,3363,495,2868,2780,1451,1302,3,10,0,14,88
17031828401,828401,1.470888729,south,ccdph,3598,300,3298,3149,2030,1062,0,37,0,20,149
17031828402,828402,1.524307772,south,ccdph,3688,423,3265,3120,1302,1767,6,27,0,18,145
17031828503,828503,3.571158708,south,ccdph,4322,607,3715,3602,607,2933,6,17,3,36,113
17031828504,828504,4.078680188,south,ccdph,5474,819,4655,4408,925,3434,3,21,0,25,247
17031828505,828505,4.816457509,south,ccdph,6682,1427,5255,5137,1913,3117,3,61,2,41,118
17031828507,828507,1.755912535,south,ccdph,3999,303,3696,3587,670,2862,6,35,0,14,109
17031828508,828508,2.734479967,south,ccdph,4630,375,4255,4124,723,3360,7,23,0,11,131
17031828601,828601,1.125668873,south,ccdph,4198,514,3684,3536,2378,1081,4,56,0,17,148
17031828602,828602,0.906740524,south,ccdph,4666,344,4322,4141,1349,2672,2,85,0,33,181
17031828701,828701,2.616399685,south,ccdph,3780,325,3455,3368,700,2645,5,5,0,13,87
17031828702,828702,4.260841783,south,ccdph,4742,454,4288,4175,538,3605,1,6,3,22,113
17031720600,720600,0.224341539,outside,chicago,1691,73,1618,1591,1277,293,5,14,0,2,27
17031720700,720700,0.405079226,outside,chicago,3073,164,2909,2779,890,1837,0,31,3,18,130
17031730100,730100,0.253375361,outside,chicago,2462,59,2403,2376,9,2361,0,5,0,1,27
17031817900,817900,1.276655851,west,ccdph,5532,804,4728,4598,448,4060,0,70,0,20,130
17031817500,817500,0.722866233,west,ccdph,3612,1179,2433,2357,78,2247,4,18,1,9,76
17031817600,817600,0.399196218,west,ccdph,3825,949,2876,2805,94,2653,7,34,0,17,71
17031817700,817700,0.560931415,west,ccdph,4803,1005,3798,3725,86,3612,3,10,3,11,73
17031818000,818000,1.35508842,west,ccdph,4428,1078,3350,3268,1244,1859,8,135,0,22,82
17031818100,818100,0.516496136,west,ccdph,2330,631,1699,1635,1166,350,5,104,0,10,64
17031818200,818200,0.771524625,west,ccdph,4762,1215,3547,3401,1701,1510,7,167,1,15,146
17031818300,818300,1.226581555,west,ccdph,5922,2335,3587,3511,879,2423,6,181,1,21,76
17031818401,818401,2.63516136,west,ccdph,3613,965,2648,2563,1268,1157,8,110,1,19,85
17031818402,818402,0.492601847,west,ccdph,3282,684,2598,2539,1642,720,0,152,0,25,59
17031818500,818500,2.170973602,west,ccdph,5650,792,4858,4756,3809,706,0,240,1,0,102
17031818600,818600,0.956016382,west,ccdph,5093,719,4374,4203,3717,306,5,153,2,20,171
17031818700,818700,0.588796259,west,ccdph,3691,805,2886,2795,2641,78,16,54,1,5,91
17031818800,818800,0.703835393,west,ccdph,5692,1189,4503,4287,4089,93,4,76,2,23,216
17031818900,818900,0.572883537,west,ccdph,4496,635,3861,3757,3351,267,4,127,0,8,104
17031819000,819000,2.420872669,west,ccdph,4768,313,4455,4316,4243,15,4,48,0,6,139
17031819100,819100,1.025877277,west,ccdph,4600,2095,2505,2372,1984,278,9,76,0,25,133
17031819200,819200,0.959415568,west,ccdph,6154,3227,2927,2798,2482,185,7,105,1,18,129
17031819300,819300,0.397302207,west,ccdph,2777,848,1929,1853,1687,100,3,52,0,11,76
17031819400,819400,0.636473509,west,ccdph,5686,1939,3747,3552,3068,315,3,154,0,12,195
17031819500,819500,0.564967875,west,ccdph,3664,490,3174,3024,2493,429,5,85,0,12,150
17031819600,819600,0.570406571,west,ccdph,4083,267,3816,3689,3598,36,0,47,0,8,127
17031819700,819700,0.93902513,west,ccdph,6028,262,5766,5538,5443,19,1,65,0,10,228
17031819801,819801,0.843519724,west,ccdph,5364,208,5156,5007,4904,18,0,75,0,10,149
17031819802,819802,0.670232438,west,ccdph,2741,125,2616,2554,2503,10,0,39,1,1,62
17031819900,819900,0.810675183,west,ccdph,3514,172,3342,3254,3198,12,2,34,0,8,88
17031829000,829000,0.889124566,south,ccdph,882,79,803,770,13,748,0,7,0,2,33
17031828801,828801,1.662174488,south,ccdph,5122,896,4226,4028,1741,2183,4,79,3,18,198
17031828802,828802,0.628795958,south,ccdph,2982,860,2122,2019,964,1041,0,4,0,10,103
17031828900,828900,1.233156851,south,ccdph,3399,1810,1589,1539,328,1201,5,1,0,4,50
17031829100,829100,1.008708738,south,ccdph,3512,2406,1106,1053,267,771,0,4,3,8,53
17031829200,829200,1.018004452,south,ccdph,5547,2742,2805,2694,1023,1617,10,15,13,16,111
17031829301,829301,1.260984838,south,ccdph,3931,1007,2924,2832,978,1807,6,13,0,28,92
17031829302,829302,0.740721917,south,ccdph,3633,1003,2630,2554,238,2267,7,10,6,26,76
17031829401,829401,0.423165831,south,ccdph,1049,166,883,868,17,851,0,0,0,0,15
17031829402,829402,2.124123542,south,ccdph,3088,187,2901,2746,675,2017,1,39,9,5,155
17031829500,829500,2.009707037,south,ccdph,4001,1897,2104,2001,1249,670,5,66,2,9,103
17031829600,829600,0.619796558,south,ccdph,3035,793,2242,2105,1520,517,2,50,2,14,137
17031829700,829700,7.123894264,south,ccdph,3344,315,3029,2956,698,2215,11,20,0,12,73
17031070400,70400,0.125121013,outside,chicago,3250,235,3015,2871,2554,135,3,173,0,6,144
17031070500,70500,0.117837608,outside,chicago,3322,216,3106,2995,2671,126,0,196,0,2,111
17031070600,70600,0.132407119,outside,chicago,3449,277,3172,3043,2679,36,2,311,0,15,129
17031070700,70700,0.267221539,outside,chicago,3699,428,3271,3094,2462,147,5,463,1,16,177
17031071000,71000,0.129181363,outside,chicago,4357,366,3991,3808,3320,194,4,271,4,15,183
17031071100,71100,0.12555124,outside,chicago,3091,211,2880,2755,2484,110,1,156,0,4,125
17031071200,71200,0.125357303,outside,chicago,2973,198,2775,2659,2276,133,2,235,4,9,116
17031071300,71300,0.119462034,outside,chicago,3893,222,3671,3510,3146,51,0,295,1,17,161
17031241600,241600,0.113507818,outside,chicago,3534,678,2856,2737,2327,130,4,268,2,6,119
17031242000,242000,0.126119325,outside,chicago,4692,1057,3635,3451,2409,731,3,292,0,16,184
17031242100,242100,0.126476197,outside,chicago,3976,585,3391,3191,2802,71,0,305,4,9,200
17031242200,242200,0.126206423,outside,chicago,4082,592,3490,3275,2911,124,2,221,4,13,215
17031242300,242300,0.126651969,outside,chicago,3568,439,3129,2971,2681,76,8,192,0,14,158
17031242400,242400,0.126583321,outside,chicago,2902,282,2620,2516,2314,59,1,129,0,13,104
17031242500,242500,0.119482481,outside,chicago,3426,940,2486,2375,2084,174,2,107,0,8,111
17031242600,242600,0.183524701,outside,chicago,5665,2036,3629,3428,2798,458,7,142,1,22,201
17031242700,242700,0.06769116,outside,chicago,1938,748,1190,1143,707,390,0,39,2,5,47
17031242800,242800,0.169707401,outside,chicago,1507,252,1255,1192,1091,33,5,52,1,10,63
17031242900,242900,0.125068173,outside,chicago,1962,356,1606,1505,1330,81,0,93,0,1,101
17031243000,243000,0.125221128,outside,chicago,2234,542,1692,1576,1352,76,3,133,0,12,116
17031243100,243100,0.124989594,outside,chicago,2249,753,1496,1392,1159,37,1,177,0,18,104
17031243200,243200,0.12503018,outside,chicago,2287,624,1663,1564,1336,66,2,148,2,10,99
17031243300,243300,0.127030251,outside,chicago,2431,460,1971,1884,1675,59,0,127,0,23,87
17031243400,243400,0.125913144,outside,chicago,2880,834,2046,1955,1616,175,0,157,0,7,91
17031243500,243500,0.25365747,outside,chicago,4746,441,4305,4111,3201,453,5,422,0,30,194
17031250200,250200,0.192988726,outside,chicago,2779,1431,1348,1314,59,1223,3,22,0,7,34
17031250300,250300,0.238233503,outside,chicago,4742,1902,2840,2808,72,2698,5,24,0,9,32
17031250400,250400,0.504600643,outside,chicago,5789,1680,4109,4013,77,3895,8,17,0,16,96
17031250500,250500,0.795720524,outside,chicago,7315,2414,4901,4710,2404,2107,7,170,0,22,191
17031250600,250600,0.249967055,outside,chicago,4203,842,3361,3313,53,3236,2,11,0,11,48
17031250700,250700,0.255843078,outside,chicago,5932,1211,4721,4644,39,4587,5,6,0,7,77
17031480200,480200,0.110582879,outside,chicago,1103,31,1072,1059,2,1050,0,1,0,6,13
17031480300,480300,0.160640086,outside,chicago,1348,14,1334,1323,15,1300,2,1,0,5,11
17031480400,480400,0.697762255,outside,chicago,5650,104,5546,5426,32,5362,13,10,0,9,120
17031480500,480500,0.525888576,outside,chicago,2986,449,2537,2501,50,2419,13,4,0,15,36
17031490200,490200,0.334872362,outside,chicago,3040,55,2985,2913,19,2879,1,9,0,5,72
17031490500,490500,0.54619542,outside,chicago,1995,52,1943,1905,22,1858,7,5,0,13,38
17031490600,490600,0.264593119,outside,chicago,1443,31,1412,1378,1,1369,2,3,0,3,34
17031490700,490700,0.24601877,outside,chicago,2656,88,2568,2515,4,2509,1,1,0,0,53
17031490800,490800,0.41950099,outside,chicago,3502,61,3441,3365,24,3322,4,8,0,7,76
17031490901,490901,0.325957656,outside,chicago,3403,55,3348,3270,17,3243,0,0,0,10,78
17031490902,490902,0.461392731,outside,chicago,4647,71,4576,4490,15,4455,0,1,0,19,86
17031491000,491000,0.495208461,outside,chicago,3807,160,3647,3571,36,3511,7,4,0,13,76
17031491100,491100,0.507904443,outside,chicago,4079,74,4005,3913,47,3843,9,3,4,7,92
17031491200,491200,0.250502174,outside,chicago,2019,47,1972,1945,18,1923,0,2,0,2,27
17031491300,491300,0.249351805,outside,chicago,2023,61,1962,1934,16,1909,2,2,0,5,28
17031491400,491400,0.320307975,outside,chicago,2593,80,2513,2424,16,2395,1,5,1,6,89
17031500100,500100,1.020579126,outside,chicago,3545,62,3483,3423,13,3408,1,0,0,1,60
17031500200,500200,0.789614673,outside,chicago,1688,45,1643,1604,10,1580,1,4,1,8,39
17031500300,500300,0.270805247,outside,chicago,1587,386,1201,1149,421,716,8,4,0,0,52
17031510100,510100,0.905910471,outside,chicago,3231,2701,530,505,259,215,8,13,2,8,25
17031510200,510200,0.498330398,outside,chicago,2922,602,2320,2282,110,2160,2,0,0,10,38
17031510300,510300,1.144119149,outside,chicago,4850,94,4756,4646,16,4609,8,1,0,12,110
17031520100,520100,0.96639575,outside,chicago,1745,1437,308,293,154,128,1,4,2,4,15
17031520200,520200,0.472034746,outside,chicago,3338,2689,649,625,232,367,8,7,2,9,24
17031520300,520300,0.369562543,outside,chicago,5675,4943,732,696,486,148,15,17,0,30,36
17031520400,520400,0.280061698,outside,chicago,4055,3476,579,547,423,100,0,8,0,16,32
17031520500,520500,0.40576393,outside,chicago,4420,3269,1151,1103,948,113,9,23,0,10,48
17031520600,520600,0.419994865,outside,chicago,2530,2052,478,455,387,54,6,5,0,3,23
17031530100,530100,0.250354642,outside,chicago,2197,996,1201,1152,62,1062,3,8,0,17,49
17031530200,530200,0.500499669,outside,chicago,4128,152,3976,3886,30,3830,4,0,0,22,90
17031530300,530300,0.505027087,outside,chicago,3964,86,3878,3791,13,3755,1,2,0,20,87
17031530400,530400,0.506170031,outside,chicago,2059,95,1964,1911,20,1881,2,4,0,4,53
17031530501,530501,0.500121259,outside,chicago,4514,116,4398,4319,48,4234,11,5,0,21,79
17031530502,530502,0.311539774,outside,chicago,1570,19,1551,1534,0,1529,5,0,0,0,17
17031530503,530503,0.639239925,outside,chicago,4898,80,4818,4760,22,4714,2,6,0,16,58
17031730400,730400,0.495975468,outside,chicago,3386,88,3298,3247,14,3226,3,0,0,4,51
17031730201,730201,0.385431542,outside,chicago,5627,116,5511,5381,9,5341,5,3,0,23,130
17031730202,730202,0.335934241,outside,chicago,2893,38,2855,2808,10,2785,0,2,0,11,47
17031730300,730300,0.115612423,outside,chicago,1046,34,1012,1000,1,989,0,2,0,8,12
17031730500,730500,0.508251299,outside,chicago,4220,87,4133,4049,18,4008,6,4,0,13,84
17031730600,730600,0.388282771,outside,chicago,3254,39,3215,3154,25,3118,3,4,0,4,61
17031730700,730700,0.381257323,outside,chicago,2281,83,2198,2157,9,2125,0,11,0,12,41
17031740100,740100,0.340582567,outside,chicago,3234,525,2709,2634,2486,84,6,33,0,25,75
17031740200,740200,0.761392024,outside,chicago,5830,613,5217,5125,4936,117,4,36,0,32,92
17031740300,740300,0.509424204,outside,chicago,4869,436,4433,4333,4230,67,1,11,0,24,100
17031740400,740400,1.094677779,outside,chicago,4695,420,4275,4151,3604,485,7,36,1,18,124
17031750100,750100,0.497496668,outside,chicago,3736,103,3633,3552,11,3505,5,5,1,25,81
17031750200,750200,0.504478865,outside,chicago,3024,152,2872,2773,1020,1699,8,23,0,23,99
17031750300,750300,0.255302011,outside,chicago,2470,161,2309,2259,2063,176,0,7,0,13,50
17031750400,750400,0.385483422,outside,chicago,2909,227,2682,2599,1669,904,0,13,1,12,83
17031750500,750500,1.017353244,outside,chicago,5618,223,5395,5255,1042,4150,17,24,1,21,140
17031750600,750600,0.507245662,outside,chicago,3420,98,3322,3255,25,3215,6,1,0,8,67
17031760801,760801,0.499692954,outside,chicago,4403,438,3965,3868,2273,170,4,1386,3,32,97
17031760802,760802,2.391879028,outside,chicago,2374,243,2131,2103,2020,26,3,51,0,3,28
17031760803,760803,0.30459744,outside,chicago,6394,782,5612,5397,4691,178,8,507,0,13,215
17031770201,770201,1.088119044,north,ccdph,5894,761,5133,4986,3963,231,18,759,0,15,147
17031770202,770202,4.557830219,north,ccdph,5060,492,4568,4412,4045,70,3,285,3,6,156
17031770300,770300,5.553180901,north,ccdph,7234,1173,6061,5874,5276,132,6,443,0,17,187
17031770400,770400,2.00714082,north,ccdph,4375,997,3378,3274,2690,83,7,472,0,22,104
17031770500,770500,2.606912348,north,ccdph,4632,3948,684,651,563,41,5,32,0,10,33
17031770601,770601,1.068660386,north,ccdph,3272,549,2723,2644,2180,39,4,418,0,3,79
17031770602,770602,2.139302425,north,ccdph,4762,2256,2506,2421,1754,121,0,539,0,7,85
17031770700,770700,1.801173153,west,ccdph,2537,543,1994,1925,1780,32,0,106,0,7,69
17031770800,770800,1.521997043,west,ccdph,5661,1793,3868,3775,3255,71,3,435,0,11,93
17031770901,770901,0.476166522,west,ccdph,5245,577,4668,4574,4069,23,1,467,0,14,94
17031770902,770902,0.436944759,west,ccdph,3732,306,3426,3393,3132,23,0,226,5,7,33
17031800100,800100,1.216970834,north,ccdph,2395,94,2301,2225,2107,21,5,87,0,5,76
17031800200,800200,2.874274943,north,ccdph,6466,279,6187,5935,5538,71,3,290,0,33,252
17031800300,800300,1.32726418,north,ccdph,3613,146,3467,3356,3185,10,0,146,3,12,111
17031800400,800400,1.132160664,north,ccdph,3936,172,3764,3610,3448,4,2,137,0,19,154
17031800500,800500,1.313814862,north,ccdph,5133,195,4938,4760,4562,15,2,165,0,16,178
17031800600,800600,0.595812575,north,ccdph,2429,93,2336,2259,2137,8,2,100,0,12,77
17031800700,800700,1.53850904,north,ccdph,5257,229,5028,4793,4315,17,2,445,0,14,235
17031800800,800800,1.634584841,north,ccdph,2426,156,2270,2177,1852,8,0,309,0,8,93
17031800900,800900,0.821480927,north,ccdph,4505,384,4121,3949,2666,71,0,1203,0,9,172
17031801000,801000,0.973852486,north,ccdph,5337,217,5120,4866,3867,46,3,918,3,29,254
17031801100,801100,0.724585337,north,ccdph,4871,261,4610,4353,4033,31,4,252,0,33,257
17031801200,801200,0.755524238,north,ccdph,3651,94,3557,3444,3268,12,2,148,0,14,113
17031801300,801300,0.721834018,north,ccdph,4430,212,4218,4027,3677,51,1,272,1,25,191
17031801400,801400,0.553094444,north,ccdph,2922,126,2796,2668,2076,37,2,537,0,16,128
17031801500,801500,3.952020612,north,ccdph,6572,297,6275,6085,5216,104,4,745,0,16,190
17031071700,71700,0.061889686,outside,chicago,1660,91,1569,1495,1178,156,1,149,0,11,74
17031071400,71400,0.283958851,outside,chicago,4962,345,4617,4435,3750,248,0,411,2,24,182
17031071500,71500,0.379845724,outside,chicago,6282,328,5954,5730,5149,249,1,309,0,22,224
17031071600,71600,0.062414755,outside,chicago,1793,94,1699,1615,1349,103,2,137,0,24,84
17031071800,71800,0.124849995,outside,chicago,2652,160,2492,2398,1781,397,1,208,1,10,94
17031080100,80100,0.100674394,outside,chicago,6388,359,6029,5854,5346,144,0,348,0,16,175
17031080201,80201,0.052266342,outside,chicago,3375,174,3201,3101,2840,81,0,169,0,11,100
17031080202,80202,0.059895329,outside,chicago,4225,310,3915,3791,3376,73,4,321,1,16,124
17031080300,80300,0.139485787,outside,chicago,5499,324,5175,5000,4319,283,6,366,4,22,175
17031080400,80400,0.126235029,outside,chicago,4569,191,4378,4241,1603,2420,5,199,0,14,137
17031081000,81000,0.115236876,outside,chicago,8746,617,8129,7850,5866,943,25,998,0,18,279
17031081100,81100,0.039817697,outside,chicago,4187,254,3933,3785,3014,340,12,399,3,17,148
17031081201,81201,0.071154164,outside,chicago,5080,302,4778,4627,3952,242,0,416,0,17,151
17031081202,81202,0.072729947,outside,chicago,3357,126,3231,3154,2842,91,5,205,0,11,77
17031081300,81300,0.074782127,outside,chicago,5540,360,5180,5022,4114,187,0,695,0,26,158
17031081401,81401,0.105835584,outside,chicago,2508,189,2319,2245,1671,127,4,431,2,10,74
17031081402,81402,0.189475876,outside,chicago,7052,430,6622,6353,4555,372,7,1370,0,49,269
17031081403,81403,0.140045533,outside,chicago,9843,765,9078,8701,6081,397,8,2172,4,39,377
17031081500,81500,0.114129545,outside,chicago,5917,348,5569,5365,4220,172,2,949,4,18,204
17031081600,81600,0.051267756,outside,chicago,4168,276,3892,3731,2943,116,1,635,2,34,161
17031081700,81700,0.143398358,outside,chicago,5537,406,5131,4938,3883,273,13,748,0,21,193
17031081800,81800,0.288650223,outside,chicago,11373,590,10783,10397,8912,248,7,1185,3,42,386
17031081900,81900,0.052946017,outside,chicago,1325,92,1233,1180,748,337,1,91,1,2,53
17031090100,90100,0.357500385,outside,chicago,3585,452,3133,3024,2901,17,5,95,0,6,109
17031090200,90200,0.589635504,outside,chicago,6626,677,5949,5784,5513,38,1,196,0,36,165
17031090300,90300,0.184047354,outside,chicago,1314,110,1204,1173,1124,7,0,17,0,25,31
17031100100,100100,0.4551427,outside,chicago,5538,1089,4449,4314,3798,60,22,403,2,29,135
17031100200,100200,0.787520202,outside,chicago,7024,1082,5942,5733,5389,73,3,225,0,43,209
17031100300,100300,0.900056117,outside,chicago,6252,723,5529,5378,5069,30,2,249,0,28,151
17031100400,100400,0.373418442,outside,chicago,3207,419,2788,2685,2538,16,4,116,3,8,103
17031100500,100500,0.770011181,outside,chicago,6116,925,5191,5003,4441,87,4,437,0,34,188
17031100600,100600,0.494290477,outside,chicago,4897,1041,3856,3738,3282,57,5,378,0,16,118
17031100700,100700,0.468972336,outside,chicago,4967,943,4024,3911,3460,36,7,388,1,19,113
17031110100,110100,0.721141262,outside,chicago,5568,1127,4441,4260,3582,154,8,495,0,21,181
17031110200,110200,0.229931487,outside,chicago,2772,778,1994,1934,1662,36,6,213,0,17,60
17031110300,110300,0.466293745,outside,chicago,5348,1244,4104,3950,3345,62,8,523,0,12,154
17031110400,110400,0.362041296,outside,chicago,4522,1136,3386,3250,2723,72,3,434,0,18,136
17031110501,110501,0.305433302,outside,chicago,4786,1222,3564,3394,2687,44,9,643,0,11,170
17031805201,805201,0.707506802,north,ccdph,3475,243,3232,3165,2170,53,5,931,0,6,67
17031805202,805202,0.604222267,north,ccdph,4078,302,3776,3616,2783,59,4,760,1,9,160
17031805301,805301,0.408961637,north,ccdph,3588,334,3254,3174,1859,69,5,1238,0,3,80
17031805302,805302,0.597669736,north,ccdph,3873,312,3561,3460,2179,52,4,1222,2,1,101
17031805401,805401,1.007750803,north,ccdph,4056,508,3548,3447,2969,21,5,443,2,7,101
17031805402,805402,0.761409153,north,ccdph,5467,450,5017,4877,4016,35,0,810,0,16,140
17031805501,805501,0.77566398,north,ccdph,3998,413,3585,3485,3265,33,0,186,0,1,100
17031805502,805502,0.71730517,north,ccdph,4295,185,4110,3984,3867,15,3,89,0,10,126
17031805600,805600,0.729143625,north,ccdph,4710,238,4472,4338,4197,12,2,123,0,4,134
17031251200,251200,0.255543148,outside,chicago,3910,948,2962,2897,21,2861,8,3,0,4,65
17031250800,250800,0.221363119,outside,chicago,2432,734,1698,1668,30,1621,2,6,0,9,30
17031251000,251000,0.182323977,outside,chicago,1075,272,803,778,15,758,3,0,0,2,25
17031251100,251100,0.191540937,outside,chicago,4468,1058,3410,3349,34,3282,3,15,1,14,61
17031251300,251300,0.252104994,outside,chicago,5098,895,4203,4126,69,4037,3,7,0,10,77
17031251400,251400,0.265538855,outside,chicago,3986,375,3611,3539,206,3307,0,7,0,19,72
17031251500,251500,0.264114777,outside,chicago,4342,711,3631,3556,78,3466,3,4,1,4,75
17031251600,251600,0.185524657,outside,chicago,3522,579,2943,2860,23,2827,0,5,0,5,83
17031251700,251700,0.186181643,outside,chicago,1347,439,908,887,18,863,2,2,0,2,21
17031251800,251800,0.384882105,outside,chicago,5101,313,4788,4725,22,4687,4,0,1,11,63
17031251900,251900,0.24379523,outside,chicago,5387,362,5025,4955,84,4841,5,8,0,17,70
17031252000,252000,0.240939542,outside,chicago,5646,246,5400,5324,91,5199,12,14,1,7,76
17031252101,252101,0.328356829,outside,chicago,1502,60,1442,1412,36,1373,0,1,2,0,30
17031252102,252102,0.258783671,outside,chicago,6187,300,5887,5802,29,5755,4,2,0,12,85
17031252201,252201,0.149211163,outside,chicago,2940,266,2674,2635,19,2606,4,2,2,2,39
17031252202,252202,0.24605515,outside,chicago,4783,255,4528,4468,33,4412,4,3,0,16,60
17031260100,260100,0.125481133,outside,chicago,1477,81,1396,1365,31,1330,3,0,0,1,31
17031260200,260200,0.126641999,outside,chicago,1054,79,975,957,17,926,5,4,0,5,18
17031260300,260300,0.127179923,outside,chicago,1528,131,1397,1381,14,1354,4,5,0,4,16
17031260400,260400,0.126497766,outside,chicago,1398,86,1312,1278,3,1269,5,0,0,1,34
17031260500,260500,0.130075711,outside,chicago,1833,128,1705,1679,17,1656,4,0,0,2,26
17031260600,260600,0.122581502,outside,chicago,2114,177,1937,1908,7,1894,6,0,0,1,29
17031260700,260700,0.127046836,outside,chicago,1691,164,1527,1472,33,1426,3,2,0,8,55
17031820000,820000,0.664998222,west,ccdph,2230,148,2082,1986,1585,43,0,348,0,10,96
17031820101,820101,2.70490387,west,ccdph,7889,475,7414,7257,6678,147,4,411,0,17,157
17031820103,820103,1.17469455,west,ccdph,4285,891,3394,3275,3004,143,2,115,0,11,119
17031820104,820104,1.264639237,west,ccdph,4453,964,3489,3377,3051,196,2,122,0,6,112
17031820202,820202,8.791488989,west,ccdph,3128,1007,2121,2043,1952,29,16,39,0,7,78
17031820203,820203,2.380833869,west,ccdph,4038,348,3690,3587,3210,55,0,308,0,14,103
17031820204,820204,2.719865951,west,ccdph,4434,581,3853,3758,3445,69,4,229,1,10,95
17031820300,820300,0.549555714,southwest,ccdph,5588,3826,1762,1715,1332,156,6,203,1,17,47
17031820400,820400,0.996182704,southwest,ccdph,5556,4290,1266,1202,451,696,14,19,2,20,64
17031820501,820501,2.629391774,southwest,ccdph,5905,1530,4375,4241,3994,114,10,112,0,11,134
17031820502,820502,1.414673358,southwest,ccdph,5380,1272,4108,3993,3486,348,5,136,4,14,115
17031820603,820603,1.080816736,southwest,ccdph,5530,1652,3878,3758,3381,246,7,114,2,8,120
17031820604,820604,1.122742386,southwest,ccdph,3689,558,3131,3032,2844,137,6,31,0,14,99
17031820605,820605,0.634638383,southwest,ccdph,4523,615,3908,3778,1435,2282,5,50,0,6,130
17031820606,820606,1.345866741,southwest,ccdph,3866,598,3268,3173,2895,172,5,95,0,6,95
17031820700,820700,1.958157686,outside,scc,7110,4568,2542,2420,2111,168,11,91,1,38,122
17031820800,820800,2.331020284,outside,scc,3695,2232,1463,1402,1278,64,1,54,0,5,61
17031820901,820901,4.460706993,outside,scc,5582,2280,3302,3209,2909,123,11,137,2,27,93
17031820902,820902,0.874895285,outside,scc,5051,2608,2443,2385,2119,103,0,150,0,13,58
17031821001,821001,0.760522868,outside,scc,5205,1544,3661,3536,3288,79,0,164,0,5,125
17031821002,821002,0.855125553,outside,scc,5764,2020,3744,3636,3408,95,7,105,3,18,108
17031821101,821101,0.663722508,outside,scc,4876,1776,3100,2981,2690,41,10,226,0,14,119
17031821102,821102,0.758646509,outside,scc,4231,2030,2201,2121,1849,99,5,157,0,11,80
17031550100,550100,3.200873109,outside,chicago,7019,4030,2989,2886,2130,687,9,32,1,27,103
17031530600,530600,0.396311934,outside,chicago,2774,54,2720,2666,15,2640,0,0,1,10,54
17031540101,540101,1.492032963,outside,chicago,4324,151,4173,4092,32,4040,7,6,2,5,81
17031540102,540102,2.047769406,outside,chicago,2938,55,2883,2804,9,2790,2,0,0,3,79
17031550200,550200,2.08110474,outside,chicago,2969,1733,1236,1184,979,187,3,12,0,3,52
17031560100,560100,0.286465169,outside,chicago,1477,993,484,473,163,223,1,84,0,2,11
17031560200,560200,0.254992354,outside,chicago,1710,630,1080,1060,31,1027,0,0,1,1,20
17031560300,560300,0.252310743,outside,chicago,3253,2337,916,887,653,172,1,56,0,5,29
17031560400,560400,0.130609694,outside,chicago,1630,1229,401,382,278,22,0,79,0,3,19
17031560700,560700,0.255303432,outside,chicago,3635,2418,1217,1192,1066,51,9,44,1,21,25
17031560800,560800,0.509279073,outside,chicago,5682,2965,2717,2652,2505,61,16,54,0,16,65
17031829800,829800,2.013393464,south,ccdph,6891,347,6544,6262,2427,3696,7,107,1,24,282
17031829902,829902,5.028006952,south,ccdph,6457,213,6244,6045,574,5383,4,60,3,21,199
17031829903,829903,0.974340453,south,ccdph,4529,285,4244,4137,267,3806,6,51,0,7,107
17031829904,829904,4.318980694,south,ccdph,4168,226,3942,3868,1869,1854,3,118,0,24,74
17031830001,830001,1.038367877,south,ccdph,2432,701,1731,1673,1419,184,4,62,0,4,58
17031830003,830003,4.114547164,south,ccdph,7640,241,7399,7195,203,6878,9,57,2,46,204
17031830004,830004,3.259461707,south,ccdph,7529,286,7243,7084,556,6383,7,94,0,44,159
17031830005,830005,2.706707477,south,ccdph,3768,130,3638,3551,560,2901,0,58,0,32,87
17031830006,830006,2.241479355,south,ccdph,2526,201,2325,2241,453,1749,2,27,0,10,84
17031830007,830007,1.472214626,south,ccdph,4638,296,4342,4240,375,3801,16,29,0,19,102
17031830008,830008,4.57599747,south,ccdph,4342,176,4166,4080,221,3811,3,34,0,11,86
17031830100,830100,0.615954274,south,ccdph,3297,273,3024,2927,414,2448,11,23,0,31,97
17031830201,830201,1.124348491,south,ccdph,5105,201,4904,4752,507,4191,7,37,1,9,152
17031830202,830202,1.221989485,south,ccdph,3377,283,3094,2982,606,2346,0,13,0,17,112
17031830300,830300,0.886969588,south,ccdph,5369,331,5038,4871,761,4028,2,35,0,45,167
17031830400,830400,0.925262499,south,ccdph,4091,424,3667,3474,924,2508,4,22,0,16,193
17031830500,830500,1.586209669,outside,chicago,4410,4260,150,131,73,36,3,6,0,13,19
17031830600,830600,0.255136342,outside,chicago,4935,1933,3002,2788,1626,795,8,324,0,35,214
17031830700,830700,0.335633302,outside,chicago,4006,548,3458,3286,1704,1267,10,291,4,10,172
17031830800,830800,0.129796835,outside,chicago,2405,400,2005,1895,1661,75,6,144,0,9,110
17031830900,830900,0.398812567,outside,chicago,3076,969,2107,2008,1663,126,5,197,2,15,99
17031831000,831000,0.108223995,outside,chicago,2633,252,2381,2259,2048,42,0,163,1,5,122
17031831100,831100,0.50750896,outside,chicago,6697,3515,3182,3007,2432,196,6,343,0,30,175
17031831200,831200,0.222306662,outside,chicago,4832,4199,633,590,301,230,6,38,0,15,43
17031831300,831300,0.222325819,outside,chicago,1251,760,491,484,26,443,0,11,0,4,7
17031831400,831400,0.812040424,outside,chicago,2820,537,2283,2240,256,1929,12,29,2,12,43
17031831500,831500,0.370592017,outside,chicago,4421,2730,1691,1629,1029,391,5,189,0,15,62
17031831600,831600,0.575735793,outside,chicago,7745,5259,2486,2397,1529,614,7,167,0,80,89
17031831700,831700,0.205834181,outside,chicago,2237,1128,1109,1050,856,66,2,121,2,3,59
17031831800,831800,0.736779884,outside,chicago,5868,1574,4294,4077,2254,317,7,1429,3,67,217
17031831900,831900,0.125006186,outside,chicago,3040,243,2797,2682,2498,42,0,132,1,9,115
17031832000,832000,0.064210593,outside,chicago,2062,187,1875,1783,1631,55,1,91,0,5,92
17031832100,832100,0.085647805,outside,chicago,3410,356,3054,2905,2160,524,5,188,0,28,149
17031832200,832200,0.154571906,outside,chicago,3289,395,2894,2741,2502,52,4,167,2,14,153
17031832300,832300,0.328423633,outside,chicago,2054,305,1749,1643,1431,47,0,156,3,6,106
17031010100,10100,0.134465137,outside,chicago,4905,737,4168,3882,1527,2128,18,147,1,61,286
17031010201,10201,0.194092538,outside,chicago,6939,2173,4766,4540,1573,2496,17,368,6,80,226
17031010202,10202,0.136448195,outside,chicago,2742,731,2011,1907,991,756,4,144,0,12,104
17031010300,10300,0.176036232,outside,chicago,6305,1140,5165,4889,2772,1747,8,325,2,35,276
17031010400,10400,0.191856371,outside,chicago,5079,621,4458,4252,3002,599,6,561,0,84,206
17031010501,10501,0.077988629,outside,chicago,4206,529,3677,3467,2039,1049,10,324,1,44,210
17031010502,10502,0.069609459,outside,chicago,3278,443,2835,2651,1734,570,20,287,0,40,184
17031010503,10503,0.074974352,outside,chicago,2565,272,2293,2158,1328,408,3,399,0,20,135
17031010600,10600,0.191004339,outside,chicago,6225,1083,5142,4833,3125,1221,3,421,0,63,309
17031010701,10701,0.166338128,outside,chicago,3673,1127,2546,2417,1308,877,2,210,0,20,129
17031010702,10702,0.137430309,outside,chicago,4776,1798,2978,2791,1267,1173,17,310,2,22,187
17031020100,20100,0.157606248,outside,chicago,4202,1134,3068,2910,1014,1371,11,490,0,24,158
17031020200,20200,0.478958707,outside,chicago,7128,996,6132,5958,3821,763,13,1286,1,74,174
17031805802,805802,0.688826506,north,ccdph,5096,362,4734,4586,4292,32,2,242,0,18,148
17031805701,805701,1.066117661,north,ccdph,5485,339,5146,5003,4807,8,0,158,1,29,143
17031805702,805702,0.648705089,north,ccdph,2089,171,1918,1848,1737,2,0,97,0,12,70
17031805801,805801,0.743110085,north,ccdph,2580,139,2441,2378,2263,11,3,91,0,10,63
17031805901,805901,1.445780495,north,ccdph,4341,501,3840,3746,3132,98,3,488,1,24,94
17031805902,805902,1.166605621,north,ccdph,6503,476,6027,5876,5032,59,1,763,0,21,151
17031806001,806001,0.709549586,north,ccdph,5818,668,5150,5009,2292,289,16,2367,2,43,141
17031806002,806002,0.948108382,north,ccdph,7833,996,6837,6719,3519,394,9,2780,0,17,118
17031806004,806004,1.039963897,north,ccdph,7554,1306,6248,6116,3736,207,5,2148,0,20,132
17031806005,806005,0.225159374,north,ccdph,3258,538,2720,2649,922,189,9,1477,0,52,71
17031806006,806006,0.251879077,north,ccdph,4885,394,4491,4414,2082,133,3,2115,0,81,77
17031806102,806102,1.279109071,north,ccdph,4400,715,3685,3589,2656,146,9,756,0,22,96
17031806103,806103,1.045515548,north,ccdph,5269,739,4530,4379,3415,72,7,872,0,13,151
17031806104,806104,1.823154354,north,ccdph,4134,707,3427,3321,1800,535,12,969,0,5,106
17031806201,806201,0.242011878,north,ccdph,4908,898,4010,3927,2970,154,2,783,5,13,83
17031806202,806202,0.461947735,north,ccdph,4998,527,4471,4346,3702,150,2,472,0,20,125
17031806300,806300,0.774043019,north,ccdph,4687,973,3714,3567,3238,73,0,225,1,30,147
17031806400,806400,0.451440668,north,ccdph,2492,437,2055,1976,1714,44,1,211,0,6,79
17031806501,806501,0.322744838,north,ccdph,2665,1277,1388,1342,750,76,0,511,0,5,46
17031806502,806502,0.965218667,north,ccdph,4202,1488,2714,2618,2128,75,2,400,0,13,96
17031806600,806600,1.139151661,north,ccdph,3602,975,2627,2538,2041,68,0,417,2,10,89
17031806700,806700,0.681800677,outside,scc,4486,312,4174,3958,3070,298,0,582,0,8,216
17031806801,806801,0.863504949,outside,scc,4294,336,3958,3813,2275,241,3,1250,5,39,145
17031806802,806802,0.372148855,outside,scc,3445,310,3135,3018,1771,306,0,907,1,33,117
17031806900,806900,1.059846446,outside,scc,5342,501,4841,4687,2604,338,4,1715,0,26,154
17031807000,807000,0.438086189,outside,scc,5866,840,5026,4825,2540,592,3,1656,0,34,201
17031807100,807100,0.58916363,outside,scc,3984,358,3626,3471,2635,421,1,356,0,58,155
17031807200,807200,0.960264386,outside,scc,6059,643,5416,5161,2800,708,4,1597,0,52,255
17031807300,807300,0.782946226,outside,scc,7718,770,6948,6720,3355,674,8,2637,8,38,228
17031807400,807400,0.538661688,outside,scc,6824,842,5982,5676,3124,580,13,1923,3,33,306
17031807500,807500,0.38178475,outside,scc,3327,401,2926,2774,1504,200,2,1036,6,26,152
17031807600,807600,1.706613043,outside,scc,6705,787,5918,5681,2840,435,5,2367,0,34,237
17031807700,807700,0.656254038,outside,scc,6147,707,5440,5234,3096,348,10,1745,0,35,206
17031807800,807800,0.980728367,outside,scc,2878,307,2571,2504,1744,39,2,719,0,0,67
17031807900,807900,0.776450122,north,ccdph,4201,298,3903,3761,2577,61,1,1103,0,19,142
17031808001,808001,0.84971284,north,ccdph,3981,285,3696,3625,2140,62,1,1417,0,5,71
17031821402,821402,0.678672763,southwest,ccdph,3200,81,3119,3063,76,2961,7,2,0,17,56
17031821200,821200,1.136012191,southwest,ccdph,5641,2490,3151,3058,569,2456,7,12,0,14,93
17031821300,821300,0.741286584,southwest,ccdph,5477,2864,2613,2549,641,1839,15,26,0,28,64
17031821401,821401,0.329206825,southwest,ccdph,2870,200,2670,2629,67,2542,0,2,0,18,41
17031821500,821500,1.794555725,south,ccdph,1421,48,1373,1353,44,1304,3,0,2,0,20
17031821600,821600,1.369807808,southwest,ccdph,4542,1045,3497,3336,1298,1947,4,53,0,34,161
17031821700,821700,0.594499813,southwest,ccdph,4859,591,4268,4153,3368,707,0,52,0,26,115
17031821800,821800,0.828345104,southwest,ccdph,5415,1046,4369,4239,2866,1257,11,76,6,23,130
17031821900,821900,0.734963709,southwest,ccdph,5129,729,4400,4303,3367,864,7,51,2,12,97
17031822000,822000,0.4794228,southwest,ccdph,4343,1118,3225,3128,2979,86,7,38,2,16,97
17031822101,822101,0.717858596,southwest,ccdph,4606,1284,3322,3217,2847,265,5,87,0,13,105
17031822102,822102,0.865581484,southwest,ccdph,4504,1166,3338,3245,2203,875,6,152,0,9,93
17031822200,822200,0.539105044,southwest,ccdph,3929,1273,2656,2556,2385,110,0,39,0,22,100
17031822301,822301,0.558580775,southwest,ccdph,4088,995,3093,3011,2777,146,1,76,0,11,82
17031822302,822302,0.615759361,southwest,ccdph,4447,1120,3327,3252,2778,275,8,164,1,26,75
17031822400,822400,0.92421177,southwest,ccdph,6362,1230,5132,4956,4523,232,11,167,1,22,176
17031822500,822500,0.702905229,southwest,ccdph,4496,1070,3426,3263,2927,197,13,107,1,18,163
17031822601,822601,0.691189438,southwest,ccdph,4793,1117,3676,3557,3284,155,12,75,2,29,119
17031822602,822602,0.955304006,southwest,ccdph,7296,935,6361,6171,5173,608,3,363,0,24,190
17031822701,822701,0.414433517,southwest,ccdph,4438,1143,3295,3202,2362,654,13,166,0,7,93
17031822702,822702,0.502703021,southwest,ccdph,3828,741,3087,2980,2403,418,4,146,0,9,107
17031822801,822801,0.44360108,southwest,ccdph,3258,600,2658,2587,2146,350,4,81,0,6,71
17031832900,832900,0.155975414,outside,chicago,1995,200,1795,1719,914,85,1,710,0,9,76
17031832400,832400,0.124610407,outside,chicago,3601,917,2684,2546,2148,135,2,245,0,16,138
17031832500,832500,0.29350089,outside,chicago,3334,272,3062,2943,2478,267,0,185,1,12,119
17031832600,832600,0.279367768,outside,chicago,4147,232,3915,3785,3443,64,0,241,0,37,130
17031833000,833000,0.506246469,outside,chicago,5637,341,5296,5023,3933,384,3,679,1,23,273
17031833100,833100,0.356089484,outside,chicago,9493,709,8784,8442,5971,799,5,1609,9,49,342
17031833300,833300,0.184277858,outside,chicago,2912,277,2635,2505,1333,161,2,962,0,47,130
17031833900,833900,0.273062454,outside,chicago,2333,987,1346,1314,67,1230,0,10,0,7,32
17031834000,834000,0.371199403,outside,chicago,3609,91,3518,3447,22,3410,6,4,0,5,71
17031834200,834200,0.376229704,outside,chicago,4693,129,4564,4403,47,4310,13,8,2,23,161
17031834300,834300,0.735914454,outside,chicago,6240,120,6120,5941,35,5859,7,12,2,26,179
